fecha,positivo,positivo_rapida,positivo_molecular,muestra,muestra_rapida,muestra_molecular,sintomaticos,defunciones,inicio,inicio_molecular,inicio_rapida,recuperado,total_positivo,total_positivo_rapida,total_positivo_molecular,total_muestra,total_muestra_rapida,total_muestra_molecular,total_recuperado,total_sintomaticos,total_defunciones,total_inicio,total_inicio_molecular,total_inicio_rapida,posi,posi_rapida,posi_molecular,dias,primera_ola_positivo,segunda_ola_positivo,primera_ola_defunciones,segunda_ola_defunciones,primera_ola_tasamolecular,segunda_ola_tasamolecular
2020-03-06,,,,,,,,,1,1,1,,0,0,0,0,0,0,0,0,0,1,1,1,,,,1,,98,1,4,.19631901,.18348624
2020-03-07,,,,,,,,,2,1,1,,0,0,0,0,0,0,0,0,0,3,2,2,,,,2,,152,1,4,.18018018,.14814815
2020-03-08,,,,,,,,,1,1,1,,0,0,0,0,0,0,0,0,0,4,3,3,,,,3,,117,3,2,.22368421,.28125
2020-03-09,,,,,,,,,1,1,1,,0,0,0,0,0,0,0,0,0,5,4,4,,,,4,,37,2,7,,
2020-03-10,,,,,,,,,2,2,2,,0,0,0,0,0,0,0,0,0,7,6,6,,,,5,,111,0,5,.21649484,.29545453
2020-03-11,,,,,,,,,0,0,0,,0,0,0,0,0,0,0,0,0,7,6,6,,,,6,,73,3,4,.090909094,.1147541
2020-03-12,,,,,,,,,0,0,0,,0,0,0,0,0,0,0,0,0,7,6,6,,,,7,,132,3,6,.14423077,.35714287
2020-03-13,1,0,1,3,0,3,1,0,0,0,0,,1,0,1,3,0,3,0,1,0,7,6,6,.33333334,,.33333334,8,0,110,5,5,.11627907,.2
2020-03-14,0,0,0,1,0,0,0,0,2,1,1,,1,0,1,4,0,3,0,1,0,9,7,7,0,,,9,0,218,7,8,.11428571,
2020-03-15,0,0,0,21,0,18,0,0,4,3,3,,1,0,1,25,0,21,0,1,0,13,10,10,0,,0,10,0,159,1,6,.060301509,.28333333
2020-03-16,0,0,0,2,0,2,0,0,3,2,2,,1,0,1,27,0,23,0,1,0,16,12,12,0,,0,11,0,32,2,7,,
2020-03-17,0,0,0,1,0,1,0,0,4,2,2,,1,0,1,28,0,24,0,1,0,20,14,14,0,,0,12,0,108,2,12,.11415525,.24137931
2020-03-18,3,0,3,16,0,16,3,0,5,4,4,,4,0,4,44,0,40,0,4,0,25,18,18,.1875,,.1875,13,0,217,2,9,.11255411,.38372093
2020-03-19,0,0,0,3,0,1,0,0,2,2,2,,4,0,4,47,0,41,0,4,0,27,20,20,0,,0,14,0,318,3,10,.13450292,.31428573
2020-03-20,1,1,0,16,0,14,0,0,7,5,5,,5,1,4,63,0,55,0,4,0,34,25,25,.0625,,0,15,0,200,2,3,.17293233,.25510204
2020-03-21,0,0,0,12,0,12,0,0,4,3,3,,5,1,4,75,0,67,0,4,0,38,28,28,0,,0,16,0,284,1,11,.14598539,.21686748
2020-03-22,3,1,2,5,0,4,2,0,4,3,3,,8,2,6,80,0,71,0,6,0,42,31,31,.60000002,,.5,17,0,316,2,8,.080645159,.11764706
2020-03-23,0,0,0,19,0,19,0,0,3,2,2,,8,2,6,99,0,90,0,6,0,45,33,33,0,,0,18,0,45,5,10,,
2020-03-24,4,0,4,14,0,13,4,1,8,7,7,,12,2,10,113,0,103,0,10,1,53,40,40,.2857143,,.30769232,19,0,129,3,13,.23376623,.2173913
2020-03-25,1,1,0,2,0,0,0,0,6,6,6,,13,3,10,115,0,103,0,10,1,59,46,46,.5,,,20,0,63,2,11,.14285715,.22471911
2020-03-26,0,0,0,1,0,1,0,0,5,4,4,,13,3,10,116,0,104,0,10,1,64,50,50,0,,0,21,0,112,0,8,.16216215,.32051283
2020-03-27,2,0,2,20,0,19,2,1,5,4,4,2,15,3,12,136,0,123,2,12,2,69,54,54,.1,,.10526316,22,0,67,2,13,.081481479,.19607843
2020-03-28,16,0,16,33,0,32,16,0,2,1,1,,31,3,28,169,0,155,2,28,2,71,55,55,.4848485,,.5,23,0,26,1,9,.1010101,.30935252
2020-03-29,0,0,0,1,0,0,0,0,4,2,2,,31,3,28,170,0,155,2,28,2,75,57,57,0,,,24,0,76,1,8,.046153847,.17647059
2020-03-30,6,0,6,27,0,24,6,0,4,2,2,,37,3,34,197,0,179,2,34,2,79,59,59,.22222222,,.25,25,0,32,2,3,,0
2020-03-31,4,0,4,26,0,26,4,0,3,3,3,,41,3,38,223,0,205,2,38,2,82,62,62,.15384616,,.15384616,26,0,108,1,,.078651689,.22962964
2020-04-01,1,1,0,3,0,0,0,0,10,0,0,4,42,4,38,226,0,205,6,38,2,92,62,62,.33333334,,,27,0,130,2,,.25882354,.16107382
2020-04-02,7,1,6,19,0,15,6,1,4,1,1,,49,5,44,245,0,220,6,44,3,96,63,63,.36842105,,.40000001,28,0,75,1,,.069767445,.33689839
2020-04-03,4,0,4,18,0,17,4,0,4,1,1,,53,5,48,263,0,237,6,48,3,100,64,64,.22222222,,.23529412,29,0,71,2,,.041237112,.28260869
2020-04-04,12,8,4,654,0,8,5,0,7,3,3,,65,13,52,917,0,245,6,53,3,107,67,67,.018348623,,.5,30,0,46,1,,.051282052,.19909503
2020-04-05,2,0,2,37,0,17,2,0,7,2,2,3,67,13,54,954,0,262,9,55,3,114,69,69,.054054055,,.11764706,31,0,63,1,,.053333335,.2877095
2020-04-06,1,1,0,18,0,7,0,0,4,1,1,,68,14,54,972,0,269,9,55,3,118,70,70,.055555556,,0,32,0,33,2,,0,1
2020-04-07,1,1,0,182,0,4,0,0,4,3,3,4,69,15,54,1154,0,273,13,55,3,122,73,73,.0054945056,,0,33,0,140,4,,.0625,.28135592
2020-04-08,5,3,2,20,0,11,4,0,2,0,0,1,74,18,56,1174,0,284,14,59,3,124,73,73,.25,,.18181819,34,0,109,0,,.079545453,.26595744
2020-04-09,2,0,2,49,0,10,2,0,2,2,2,,76,18,58,1223,0,294,14,61,3,126,75,75,.040816326,,.2,35,0,147,1,,.11111111,.37979093
2020-04-10,3,3,0,17,0,0,0,0,8,2,2,2,79,21,58,1240,0,294,16,61,3,134,77,77,.17647059,,,36,0,148,1,,.027027028,.11845102
2020-04-11,39,38,1,85,0,8,3,0,3,0,0,22,118,59,59,1325,0,302,38,64,3,137,77,77,.45882353,,.125,37,0,188,1,,.052083332,.35344827
2020-04-12,0,0,0,7,0,0,0,0,2,1,1,,118,59,59,1332,0,302,38,64,3,139,78,78,0,,,38,0,135,4,,0,.39240506
2020-04-13,1,0,1,47,0,7,0,0,2,0,0,6,119,59,60,1379,0,309,44,64,3,141,78,78,.021276595,,.14285715,39,0,59,1,,.92307693,1
2020-04-14,5,3,2,31,0,8,1,0,2,0,0,5,124,62,62,1410,0,317,49,65,3,143,78,78,.16129032,,.25,40,0,168,1,,.086956523,1
2020-04-15,1,1,0,157,0,0,0,0,11,1,1,3,125,63,62,1567,0,317,52,65,3,154,79,79,.0063694268,,,41,0,163,0,,.12643678,.39548022
2020-04-16,8,6,2,525,0,6,2,0,4,0,0,7,133,69,64,2092,0,323,59,67,3,158,79,79,.015238095,,.33333334,42,0,165,1,,.15957446,.47447446
2020-04-17,11,10,1,393,0,8,1,0,10,0,0,6,144,79,65,2485,0,331,65,68,3,168,79,79,.027989822,,.125,43,0,199,0,,.22033899,.42616034
2020-04-18,14,14,0,622,0,28,2,0,7,1,1,38,158,93,65,3107,0,359,103,70,3,175,80,80,.022508038,,0,44,0,403,2,,.024390243,.50541514
2020-04-19,0,0,0,326,0,0,0,0,8,1,1,2,158,93,65,3433,0,359,105,70,3,183,81,81,0,,,45,0,302,1,,.12,.54945058
2020-04-20,18,18,0,742,0,2,4,0,20,1,1,1,176,111,65,4175,0,361,106,74,3,203,82,82,.024258761,,0,46,0,70,2,,,.51020408
2020-04-21,6,6,0,502,0,11,3,0,13,0,0,3,182,117,65,4677,0,372,109,77,3,216,82,82,.011952192,,0,47,0,272,2,,.18333334,.68345326
2020-04-22,23,22,1,516,0,5,5,1,10,1,1,3,205,139,66,5193,0,377,112,82,4,226,83,83,.044573642,,.2,48,0,204,0,,.016949153,.47413793
2020-04-23,23,21,2,347,0,3,2,0,12,1,1,6,228,160,68,5540,0,380,118,84,4,238,84,84,.066282421,,.66666669,49,0,319,0,,.081081077,
2020-04-24,9,8,1,366,0,36,2,0,11,0,0,10,237,168,69,5906,0,416,128,86,4,249,84,84,.024590164,,.027777778,50,0,274,2,,.03125,
2020-04-25,13,13,0,239,0,8,1,0,8,0,0,18,250,181,69,6145,0,424,146,87,4,257,84,84,.054393306,,0,51,0,290,0,,0,
2020-04-26,0,0,0,18,0,7,0,0,2,1,1,,250,181,69,6163,0,431,146,87,4,259,85,85,0,,0,52,0,267,0,,.043478262,
2020-04-27,14,14,0,240,0,13,2,0,9,2,2,16,264,195,69,6403,0,444,162,89,4,268,87,87,.058333334,,0,53,0,90,4,,,
2020-04-28,21,21,0,202,0,12,3,0,11,2,2,7,285,216,69,6605,0,456,169,92,4,279,89,89,.10396039,,0,54,0,226,1,,.048387095,
2020-04-29,23,21,2,425,0,29,9,0,10,0,0,11,308,237,71,7030,0,485,180,101,4,289,89,89,.054117646,,.068965517,55,0,239,3,,.30769232,
2020-04-30,39,39,0,423,0,12,10,0,12,0,0,14,347,276,71,7453,0,497,194,111,4,301,89,89,.092198581,,0,56,0,370,2,,.029411765,
2020-05-01,5,5,0,95,0,29,1,0,29,1,1,4,352,281,71,7548,0,526,198,112,4,330,90,90,.052631579,,0,57,0,271,0,,.07526882,
2020-05-02,16,16,0,170,0,4,4,0,12,2,2,13,368,297,71,7718,0,530,211,116,4,342,92,92,.094117649,,0,58,0,321,1,,.043478262,
2020-05-03,3,3,0,44,0,0,1,0,6,2,2,,371,300,71,7762,0,530,211,117,4,348,94,94,.06818182,,,59,0,203,1,,.05882353,
2020-05-04,11,10,1,440,0,21,4,0,9,2,2,16,382,310,72,8202,0,551,227,121,4,357,96,96,.025,,.047619049,60,0,162,3,,.055555556,
2020-05-05,29,29,0,663,0,22,4,0,20,3,3,22,411,339,72,8865,0,573,249,125,4,377,99,99,.043740574,,0,61,0,262,2,,.021276595,
2020-05-06,55,51,4,1016,0,11,7,0,16,3,3,25,466,390,76,9881,0,584,274,132,4,393,102,102,.054133859,,.36363637,62,0,202,1,,.010416667,
2020-05-07,47,44,3,552,0,11,7,1,9,2,2,49,513,434,79,10433,0,595,323,139,5,402,104,104,.08514493,,.27272728,63,0,30,1,,.016666668,
2020-05-08,48,47,1,680,0,16,8,0,4,0,0,9,561,481,80,11113,0,611,332,147,5,406,104,104,.070588239,,.0625,64,0,,0,,.051612902,
2020-05-09,14,14,0,326,0,14,1,0,7,1,1,16,575,495,80,11439,0,625,348,148,5,413,105,105,.042944785,,0,65,0,,3,,.014285714,
2020-05-10,2,2,0,98,0,0,1,1,16,0,0,3,577,497,80,11537,0,625,351,149,6,429,105,105,.020408163,,,66,0,,3,,.018691588,
2020-05-11,63,63,0,852,0,15,5,0,10,1,1,9,640,560,80,12389,0,640,360,154,6,439,106,106,.07394366,,0,67,0,,2,,0,
2020-05-12,44,43,1,735,0,30,2,0,16,7,7,15,684,603,81,13124,0,670,375,156,6,455,113,113,.059863947,,.033333335,68,0,,2,,.034482758,
2020-05-13,76,74,2,1175,0,10,8,1,8,5,5,40,760,677,83,14299,0,680,415,164,7,463,118,118,.064680852,,.2,69,0,,0,,.0043668123,
2020-05-14,39,39,0,426,0,23,5,0,6,2,2,23,799,716,83,14725,0,703,438,169,7,469,120,120,.091549292,,0,70,0,,0,,.03930131,
2020-05-15,10,9,1,450,0,15,4,2,17,5,5,22,809,725,84,15175,0,718,460,173,9,486,125,125,.022222223,,.06666667,71,0,,0,,.073619634,
2020-05-16,16,16,0,399,0,29,1,0,12,5,5,7,825,741,84,15574,0,747,467,174,9,498,130,130,.04010025,,0,72,0,,2,,.13043478,
2020-05-17,1,1,0,62,0,0,0,0,10,3,3,1,826,742,84,15636,0,747,468,174,9,508,133,133,.016129032,,,73,0,,4,,.17647059,
2020-05-18,19,18,1,349,0,14,2,0,16,6,6,50,845,760,85,15985,0,761,518,176,9,524,139,139,.054441262,,.071428575,74,0,,3,,,
2020-05-19,53,53,0,944,0,18,3,1,6,3,3,34,898,813,85,16929,0,779,552,179,10,530,142,142,.056144066,,0,75,0,,1,,.11864407,
2020-05-20,37,36,1,711,0,15,3,0,17,4,4,69,935,849,86,17640,0,794,621,182,10,547,146,146,.052039381,,.06666667,76,0,,2,,.081967212,
2020-05-21,49,44,5,950,0,16,12,0,3,1,1,49,984,893,91,18590,0,810,670,194,10,550,147,147,.051578946,,.3125,77,0,,0,,.125,
2020-05-22,47,44,3,883,0,11,5,0,13,6,6,34,1031,937,94,19473,0,821,704,199,10,563,153,153,.053227633,,.27272728,78,0,,0,,.21311475,
2020-05-23,34,33,1,505,0,15,4,0,4,0,0,16,1065,970,95,19978,0,836,720,203,10,567,153,153,.067326732,,.06666667,79,0,,4,,.29577464,
2020-05-24,5,5,0,106,0,0,1,1,12,3,3,2,1070,975,95,20084,0,836,722,204,11,579,156,156,.047169812,,,80,0,,0,,.078431375,
2020-05-25,45,38,7,692,0,24,12,0,26,7,7,25,1115,1013,102,20776,0,860,747,216,11,605,163,163,.065028898,,.29166666,81,0,,1,,0,
2020-05-26,32,29,3,739,0,18,4,0,11,5,5,67,1147,1042,105,21515,0,878,814,220,11,616,168,168,.043301757,,.16666667,82,0,,1,,.16129032,
2020-05-27,46,44,2,1009,0,11,5,0,9,2,2,48,1193,1086,107,22524,0,889,862,225,11,625,170,170,.045589693,,.18181819,83,0,,1,,.31666666,
2020-05-28,53,53,0,943,0,1,5,0,15,3,3,42,1246,1139,107,23467,0,890,904,230,11,640,173,173,.056203604,,0,84,0,,0,,.078947365,
2020-05-29,66,62,4,835,0,23,6,0,16,12,12,27,1312,1201,111,24302,0,913,931,236,11,656,185,185,.079041913,,.17391305,85,0,,2,,.24390244,
2020-05-30,29,29,0,582,0,0,3,0,16,3,3,28,1341,1230,111,24884,0,913,959,239,11,672,188,188,.049828179,,,86,0,,1,,.2857143,
2020-05-31,4,4,0,158,0,0,1,0,13,10,10,3,1345,1234,111,25042,0,913,962,240,11,685,198,198,.025316456,,,87,0,,1,,.03508772,
2020-06-01,44,41,3,997,0,39,8,0,37,12,12,24,1389,1275,114,26039,0,952,986,248,11,722,210,210,.044132397,,.07692308,88,0,,1,,0,
2020-06-02,43,38,5,835,0,17,8,0,20,10,10,20,1432,1313,119,26874,0,969,1006,256,11,742,220,220,.051497005,,.29411766,89,0,,5,,.057142857,
2020-06-03,46,42,4,743,0,9,11,2,18,6,6,45,1478,1355,123,27617,0,978,1051,267,13,760,226,226,.061911169,,.44444445,90,0,,9,,.079999998,
2020-06-04,67,65,2,1280,0,8,16,2,26,13,13,55,1545,1420,125,28897,0,986,1106,283,15,786,239,239,.052343749,,.25,91,0,,3,,.1,
2020-06-05,44,38,6,1080,0,11,9,1,17,6,6,63,1589,1458,131,29977,0,997,1169,292,16,803,245,245,.04074074,,.54545456,92,0,,4,,.087719299,
2020-06-06,78,44,34,895,0,41,35,0,24,12,12,30,1667,1502,165,30872,0,1038,1199,327,16,827,257,257,.087150835,,.82926828,93,0,,4,,.070422538,
2020-06-07,27,14,13,212,0,13,17,1,29,20,20,6,1694,1516,178,31084,0,1051,1205,344,17,856,277,277,.1273585,,1,94,0,,2,,.24489796,
2020-06-08,47,46,1,1472,0,8,4,0,36,12,12,53,1741,1562,179,32556,0,1059,1258,348,17,892,289,289,.031929348,,.125,95,0,,7,,0,
2020-06-09,109,103,6,1709,0,18,9,1,12,2,2,42,1850,1665,185,34265,0,1077,1300,357,18,904,291,291,.063779987,,.33333334,96,0,,5,,.18032786,
2020-06-10,50,44,6,1433,0,26,9,0,26,16,16,37,1900,1709,191,35698,0,1103,1337,366,18,930,307,307,.034891836,,.23076923,97,0,,4,,.045454547,
2020-06-11,42,40,2,1223,0,20,10,1,12,8,8,57,1942,1749,193,36921,0,1123,1394,376,19,942,315,315,.034341782,,.1,98,0,,6,,.11538462,
2020-06-12,75,47,28,1624,0,49,32,1,23,12,12,49,2017,1796,221,38545,0,1172,1443,408,20,965,327,327,.046182267,,.5714286,99,0,,5,,.18348624,
2020-06-13,37,28,9,1276,0,29,13,2,19,15,15,36,2054,1824,230,39821,0,1201,1479,421,22,984,342,342,.028996864,,.31034482,100,0,,8,,.14814815,
2020-06-14,16,16,0,120,0,0,1,0,18,9,9,13,2070,1840,230,39941,0,1201,1492,422,22,1002,351,351,.13333334,,,101,0,,6,,.28125,
2020-06-15,67,63,4,1493,0,21,10,2,37,10,10,41,2137,1903,234,41434,0,1222,1533,432,24,1039,361,361,.044876087,,.19047619,102,0,,7,,,
2020-06-16,63,57,6,1681,0,27,11,1,18,4,4,101,2200,1960,240,43115,0,1249,1634,443,25,1057,365,365,.037477691,,.22222222,103,0,,12,,.29545453,
2020-06-17,60,42,18,1676,0,35,23,4,22,5,5,55,2260,2002,258,44791,0,1284,1689,466,29,1079,370,370,.035799522,,.51428574,104,0,,9,,.1147541,
2020-06-18,44,38,6,1657,0,28,10,0,21,6,6,51,2304,2040,264,46448,0,1312,1740,476,29,1100,376,376,.026554013,,.21428572,105,0,,10,,.35714287,
2020-06-19,59,49,10,1495,0,24,13,2,17,7,7,59,2363,2089,274,47943,0,1336,1799,489,31,1117,383,383,.039464884,,.41666666,106,0,,3,,.2,
2020-06-20,65,36,29,1247,0,42,33,0,35,14,14,79,2428,2125,303,49190,0,1378,1878,522,31,1152,397,397,.0521251,,.69047618,107,0,,11,,,
2020-06-21,6,6,0,257,0,0,0,0,26,11,11,27,2434,2131,303,49447,0,1378,1905,522,31,1178,408,408,.023346303,,,108,0,,8,,.28333333,
2020-06-22,68,68,0,1555,0,15,3,0,20,12,12,73,2502,2199,303,51002,0,1393,1978,525,31,1198,420,420,.043729905,,0,109,0,,10,,,
2020-06-23,114,107,7,1877,0,17,9,0,15,7,7,73,2616,2306,310,52879,0,1410,2051,534,31,1213,427,427,.060735215,,.41176471,110,0,,13,,.24137931,
2020-06-24,64,64,0,1128,0,0,11,0,26,10,10,56,2680,2370,310,54007,0,1410,2107,545,31,1239,437,437,.056737587,,,111,0,,11,,.38372093,
2020-06-25,83,75,8,1806,0,16,13,3,23,7,7,45,2763,2445,318,55813,0,1426,2152,558,34,1262,444,444,.045957919,,.5,112,0,,8,,.31428573,
2020-06-26,103,86,17,2584,0,33,26,1,28,11,11,74,2866,2531,335,58397,0,1459,2226,584,35,1290,455,455,.039860681,,.5151515,113,0,,13,,.25510204,
2020-06-27,86,82,4,1755,0,26,16,0,23,11,11,37,2952,2613,339,60152,0,1485,2263,600,35,1313,466,466,.049002849,,.15384616,114,0,,9,,.21686748,
2020-06-28,29,28,1,337,0,1,1,3,33,14,14,7,2981,2641,340,60489,0,1486,2270,601,38,1346,480,480,.086053416,,1,115,0,,8,,.11764706,
2020-06-29,96,85,11,1695,0,19,17,0,23,12,12,58,3077,2726,351,62184,0,1505,2328,618,38,1369,492,492,.056637168,,.57894737,116,0,,3,,,
2020-06-30,93,79,14,2569,0,35,17,1,25,14,14,92,3170,2805,365,64753,0,1540,2420,635,39,1394,506,506,.036200855,,.40000001,117,0,,,,.2173913,
2020-07-01,124,120,4,3090,0,10,16,3,91,28,28,77,3294,2925,369,67843,0,1550,2497,651,42,1485,534,534,.040129449,,.40000001,118,0,,,,.22471911,
2020-07-02,151,135,16,3044,0,28,43,3,60,20,20,83,3445,3060,385,70887,0,1578,2580,694,45,1545,554,554,.049605783,,.5714286,119,0,,,,.32051283,
2020-07-03,136,121,15,3481,0,36,17,2,61,30,30,78,3581,3181,400,74368,0,1614,2658,711,47,1606,584,584,.039069232,,.41666666,120,0,,,,.19607843,
2020-07-04,98,96,2,2348,0,17,10,1,55,27,27,112,3679,3277,402,76716,0,1631,2770,721,48,1661,611,611,.04173765,,.11764706,121,0,,,,.30935252,
2020-07-05,45,32,13,694,0,28,18,2,96,50,50,15,3724,3309,415,77410,0,1659,2785,739,50,1757,661,661,.064841501,,.4642857,122,0,,,,.17647059,
2020-07-06,160,145,15,2529,0,23,24,0,94,57,57,105,3884,3454,430,79939,0,1682,2890,763,50,1851,718,718,.063266113,,.65217394,123,0,,,,0,
2020-07-07,148,126,22,3264,0,45,32,1,76,43,43,92,4032,3580,452,83203,0,1727,2982,795,51,1927,761,761,.045343138,,.48888889,124,0,,,,.22962964,
2020-07-08,128,112,16,2224,0,37,27,2,61,30,30,101,4160,3692,468,85427,0,1764,3083,822,53,1988,791,791,.057553958,,.43243244,125,0,,,,.16107382,
2020-07-09,132,110,22,2553,0,37,28,3,51,29,29,130,4292,3802,490,87980,0,1801,3213,850,56,2039,820,820,.051703878,,.5945946,126,0,,,,.33689839,
2020-07-10,188,147,41,2759,0,47,55,5,156,84,84,125,4480,3949,531,90739,0,1848,3338,905,61,2195,904,904,.068140633,,.87234044,127,0,,,,.28260869,
2020-07-11,180,133,47,2221,0,61,58,5,101,58,58,80,4660,4082,578,92960,0,1909,3418,963,66,2296,962,962,.081044577,,.77049178,128,0,,,,.19909503,
2020-07-12,37,37,0,491,0,0,2,5,98,58,58,36,4697,4119,578,93451,0,1909,3454,965,71,2394,1020,1020,.075356416,,,129,0,,,,.2877095,
2020-07-13,256,198,58,3025,0,90,72,1,111,64,64,133,4953,4317,636,96476,0,1999,3587,1037,72,2505,1084,1084,.084628098,,.64444447,130,0,,,,1,
2020-07-14,303,248,55,3076,0,74,76,3,118,49,49,137,5256,4565,691,99552,0,2073,3724,1113,75,2623,1133,1133,.098504551,,.74324322,131,0,,,,.28135592,
2020-07-15,277,218,59,3872,0,96,76,4,175,84,84,126,5533,4783,750,103424,0,2169,3850,1189,79,2798,1217,1217,.071539253,,.61458331,132,0,,,,.26595744,
2020-07-16,323,285,38,3213,0,48,64,6,121,67,67,126,5856,5068,788,106637,0,2217,3976,1253,85,2919,1284,1284,.1005291,,.79166669,133,0,,,,.37979093,
2020-07-17,345,285,60,3783,0,77,76,5,158,90,90,172,6201,5353,848,110420,0,2294,4148,1329,90,3077,1374,1374,.091197461,,.77922076,134,0,,,,.11845102,
2020-07-18,267,188,79,3243,0,139,101,6,184,103,103,135,6468,5541,927,113663,0,2433,4283,1430,96,3261,1477,1477,.082331173,,.56834531,135,0,,,,.35344827,
2020-07-19,55,55,0,658,0,1,8,4,179,96,96,52,6523,5596,927,114321,0,2434,4335,1438,100,3440,1573,1573,.083586626,,0,136,0,,,,.39240506,
2020-07-20,364,324,40,3741,0,56,100,7,316,148,148,211,6887,5920,967,118062,0,2490,4546,1538,107,3756,1721,1721,.097300187,,.71428573,137,0,,,,1,
2020-07-21,419,294,125,3404,0,180,157,4,199,110,110,239,7306,6214,1092,121466,0,2670,4785,1695,111,3955,1831,1831,.12309048,,.69444442,138,0,,,,1,
2020-07-22,421,306,115,3672,0,193,166,18,238,131,131,180,7727,6520,1207,125138,0,2863,4965,1861,129,4193,1962,1962,.11465142,,.59585494,139,0,,,,.39548022,
2020-07-23,373,323,50,3359,0,62,108,9,174,94,94,274,8100,6843,1257,128497,0,2925,5239,1969,138,4367,2056,2056,.11104495,,.80645162,140,0,,,,.47447446,
2020-07-24,466,384,82,4421,0,133,135,6,203,119,119,301,8566,7227,1339,132918,0,3058,5540,2104,144,4570,2175,2175,.10540602,,.61654133,141,0,,,,.42616034,
2020-07-25,523,377,146,3224,0,245,190,12,260,124,124,224,9089,7604,1485,136142,0,3303,5764,2294,156,4830,2299,2299,.16222085,,.59591836,142,0,,,,.50541514,
2020-07-26,226,119,107,1071,0,167,128,9,245,130,130,51,9315,7723,1592,137213,0,3470,5815,2422,165,5075,2429,2429,.21101774,,.64071858,143,0,,,,.54945058,
2020-07-27,532,476,56,4251,0,86,151,17,339,175,175,333,9847,8199,1648,141464,0,3556,6148,2573,182,5414,2604,2604,.12514703,,.6511628,144,0,,,,.51020408,
2020-07-28,336,317,19,2254,0,57,65,23,318,136,136,342,10183,8516,1667,143718,0,3613,6490,2638,205,5732,2740,2740,.14906833,,.33333334,145,0,,,,.68345326,
2020-07-29,686,535,151,4049,0,250,226,12,221,106,106,373,10869,9051,1818,147767,0,3863,6863,2864,217,5953,2846,2846,.16942455,,.60399997,146,0,,,,.47413793,
2020-07-30,692,530,162,4516,0,258,246,23,211,105,105,321,11561,9581,1980,152283,0,4121,7184,3110,240,6164,2951,2951,.15323295,,.62790698,147,0,,,,,
2020-07-31,721,619,102,5058,0,174,185,33,209,107,107,404,12282,10200,2082,157341,0,4295,7588,3295,273,6373,3058,3058,.14254646,,.58620691,148,0,,,,,
2020-08-01,593,534,59,3735,0,92,118,28,511,203,203,378,12875,10734,2141,161076,0,4387,7966,3413,301,6884,3261,3261,.1587684,,.64130437,149,0,,,,,
2020-08-02,188,187,1,1040,0,1,56,22,214,84,84,102,13063,10921,2142,162116,0,4388,8068,3469,323,7098,3345,3345,.18076923,,1,150,0,,,,,
2020-08-03,905,799,106,5306,0,173,203,19,248,74,74,461,13968,11720,2248,167422,0,4561,8529,3672,342,7346,3419,3419,.17056163,,.61271673,151,0,,,,,
2020-08-04,862,805,57,5118,0,90,162,21,202,73,73,434,14830,12525,2305,172540,0,4651,8963,3834,363,7548,3492,3492,.16842517,,.63333333,152,0,,,,,
2020-08-05,839,685,154,4254,0,213,284,15,259,78,78,581,15669,13210,2459,176794,0,4864,9544,4118,378,7807,3570,3570,.19722614,,.7230047,153,0,,,,,
2020-08-06,879,715,164,4714,0,263,250,26,197,79,79,527,16548,13925,2623,181508,0,5127,10071,4368,404,8004,3649,3649,.18646584,,.62357414,154,0,,,,,
2020-08-07,918,797,121,4607,0,207,235,27,203,95,95,632,17466,14722,2744,186115,0,5334,10703,4603,431,8207,3744,3744,.19926199,,.58454108,155,0,,,,,
2020-08-08,771,602,169,3693,0,259,259,30,232,84,84,622,18237,15324,2913,189808,0,5593,11325,4862,461,8439,3828,3828,.20877336,,.65250963,156,0,,,,,
2020-08-09,173,168,5,834,0,7,31,18,184,65,65,281,18410,15492,2918,190642,0,5600,11606,4893,479,8623,3893,3893,.20743406,,.71428573,157,0,,,,,
2020-08-10,1135,1009,126,5298,0,250,238,16,403,122,122,830,19545,16501,3044,195940,0,5850,12436,5131,495,9026,4015,4015,.21423179,,.50400001,158,0,,,,,
2020-08-11,1320,1141,179,5307,0,303,330,23,169,54,54,700,20865,17642,3223,201247,0,6153,13136,5461,518,9195,4069,4069,.2487281,,.5907591,159,0,,,,,
2020-08-12,1031,918,113,4459,0,189,242,20,205,80,80,833,21896,18560,3336,205706,0,6342,13969,5703,538,9400,4149,4149,.23121776,,.59788358,160,0,,,,,
2020-08-13,1088,985,103,4454,0,212,203,29,157,56,56,874,22984,19545,3439,210160,0,6554,14843,5906,567,9557,4205,4205,.24427481,,.48584905,161,0,,,,,
2020-08-14,1087,948,139,4728,0,258,240,29,228,86,86,882,24071,20493,3578,214888,0,6812,15725,6146,596,9785,4291,4291,.22990693,,.53875971,162,0,,,,,
2020-08-15,961,816,145,3599,0,260,232,30,285,86,86,692,25032,21309,3723,218487,0,7072,16417,6378,626,10070,4377,4377,.26701862,,.55769229,163,0,,,,,
2020-08-16,157,156,1,834,0,3,20,31,143,59,59,193,25189,21465,3724,219321,0,7075,16610,6398,657,10213,4436,4436,.18824939,,.33333334,164,0,,,,,
2020-08-17,1237,1149,88,5491,0,159,207,27,202,71,71,1053,26426,22614,3812,224812,0,7234,17663,6605,684,10415,4507,4507,.22527772,,.55345911,165,0,,,,,
2020-08-18,1094,954,140,4477,0,268,286,25,205,82,82,1087,27520,23568,3952,229289,0,7502,18750,6891,709,10620,4589,4589,.24436006,,.52238804,166,0,,,,,
2020-08-19,1446,1297,149,5013,0,298,287,27,124,50,50,1018,28966,24865,4101,234302,0,7800,19768,7178,736,10744,4639,4639,.28845003,,.5,167,0,,,,,
2020-08-20,1685,1532,153,7022,0,258,277,29,272,113,113,1088,30651,26397,4254,241324,0,8058,20856,7455,765,11016,4752,4752,.23996012,,.59302324,168,0,,,,,
2020-08-21,1621,1593,28,6460,0,65,200,26,129,59,59,1051,32272,27990,4282,247784,0,8123,21907,7655,791,11145,4811,4811,.25092879,,.43076923,169,0,,,,,
2020-08-22,1465,1340,125,5501,0,259,270,19,118,54,54,967,33737,29330,4407,253285,0,8382,22874,7925,810,11263,4865,4865,.26631522,,.48262548,170,0,,,,,
2020-08-23,316,316,0,1403,0,0,28,15,106,31,31,138,34053,29646,4407,254688,0,8382,23012,7953,825,11369,4896,4896,.22523165,,,171,0,,,,,
2020-08-24,2988,2904,84,9161,0,205,464,15,130,42,42,1249,37041,32550,4491,263849,0,8587,24261,8417,840,11499,4938,4938,.32616526,,.40975609,172,0,,,,,
2020-08-25,1113,1042,71,4521,0,150,178,16,119,34,34,1316,38154,33592,4562,268370,0,8737,25577,8595,856,11618,4972,4972,.24618447,,.47333333,173,0,,,,,
2020-08-26,1101,996,105,4183,0,164,198,15,89,27,27,1446,39255,34588,4667,272553,0,8901,27023,8793,871,11707,4999,4999,.26320821,,.64024389,174,0,,,,,
2020-08-27,1166,1131,35,4690,0,78,133,21,82,33,33,1681,40421,35719,4702,277243,0,8979,28704,8926,892,11789,5032,5032,.24861407,,.44871795,175,0,,,,,
2020-08-28,1391,1233,158,6047,0,331,265,21,88,31,31,1742,41812,36952,4860,283290,0,9310,30446,9191,913,11877,5063,5063,.23003142,,.47734138,176,0,,,,,
2020-08-29,792,719,73,4032,0,234,136,18,65,30,30,1504,42604,37671,4933,287322,0,9544,31950,9327,931,11942,5093,5093,.19642857,,.31196582,177,0,,,,,
2020-08-30,124,124,0,718,0,0,15,18,69,30,30,318,42728,37795,4933,288040,0,9544,32268,9342,949,12011,5123,5123,.17270195,,,178,0,,,,,
2020-08-31,1059,999,60,4988,0,167,167,23,65,24,24,3009,43787,38794,4993,293028,0,9711,35277,9509,972,12076,5147,5147,.21230954,,.35928145,179,0,,,,,
2020-09-01,898,858,40,4388,0,131,128,7,168,40,40,1171,44685,39652,5033,297416,0,9842,36448,9637,979,12244,5187,5187,.20464905,,.30534351,180,0,,,,,
2020-09-02,837,783,54,4064,0,165,131,13,72,24,24,1203,45522,40435,5087,301480,0,10007,37651,9768,992,12316,5211,5211,.20595473,,.32727271,181,0,,,,,
2020-09-03,733,702,31,3627,0,121,108,5,50,15,15,1343,46255,41137,5118,305107,0,10128,38994,9876,997,12366,5226,5226,.20209539,,.25619835,182,0,,,,,
2020-09-04,749,706,43,3661,0,175,134,5,51,20,20,1323,47004,41843,5161,308768,0,10303,40317,10010,1002,12417,5246,5246,.2045889,,.24571429,183,0,,,,,
2020-09-05,487,455,32,2780,0,126,105,10,61,31,31,903,47491,42298,5193,311548,0,10429,41220,10115,1012,12478,5277,5277,.17517985,,.25396827,184,0,,,,,
2020-09-06,115,115,0,1042,0,0,9,6,33,18,18,155,47606,42413,5193,312590,0,10429,41375,10124,1018,12511,5295,5295,.11036468,,,185,0,,,,,
2020-09-07,1237,1196,41,4972,0,188,143,2,56,22,22,1179,48843,43609,5234,317562,0,10617,42554,10267,1020,12567,5317,5317,.24879324,,.21808511,186,0,,,,,
2020-09-08,1273,1250,23,5560,0,105,124,9,47,18,18,972,50116,44859,5257,323122,0,10722,43526,10391,1029,12614,5335,5335,.22895683,,.21904762,187,0,,,,,
2020-09-09,885,845,40,4712,0,178,118,7,37,10,10,915,51001,45704,5297,327834,0,10900,44441,10509,1036,12651,5345,5345,.18781833,,.22471911,188,0,,,,,
2020-09-10,705,673,32,3779,0,163,80,10,72,31,31,782,51706,46377,5329,331613,0,11063,45223,10589,1046,12723,5376,5376,.18655729,,.19631901,189,0,,,,,
2020-09-11,737,717,20,3825,0,111,77,9,35,17,17,906,52443,47094,5349,335438,0,11174,46129,10666,1055,12758,5393,5393,.19267973,,.18018018,190,0,,,,,
2020-09-12,490,473,17,2740,0,76,74,9,34,15,15,569,52933,47567,5366,338178,0,11250,46698,10740,1064,12792,5408,5408,.17883211,,.22368421,191,0,,,,,
2020-09-13,208,208,0,875,0,0,20,4,32,13,13,117,53141,47775,5366,339053,0,11250,46815,10760,1068,12824,5421,5421,.23771429,,,192,0,,,,,
2020-09-14,710,668,42,3922,0,194,94,9,32,11,11,1215,53851,48443,5408,342975,0,11444,48030,10854,1077,12856,5432,5432,.18103008,,.21649484,193,0,,,,,
2020-09-15,567,556,11,3584,0,121,60,7,52,15,15,1239,54418,48999,5419,346559,0,11565,49269,10914,1084,12908,5447,5447,.15820313,,.090909094,194,0,,,,,
2020-09-16,516,501,15,3505,0,104,53,3,24,12,12,886,54934,49500,5434,350064,0,11669,50155,10967,1087,12932,5459,5459,.14721826,,.14423077,195,0,,,,,
2020-09-17,375,360,15,2479,0,129,42,7,29,12,12,718,55309,49860,5449,352543,0,11798,50873,11009,1094,12961,5471,5471,.15127067,,.11627907,196,0,,,,,
2020-09-18,346,326,20,2516,0,175,36,5,38,14,14,804,55655,50186,5469,355059,0,11973,51677,11045,1099,12999,5485,5485,.13751987,,.11428571,197,0,,,,,
2020-09-19,284,272,12,2114,0,199,43,2,32,12,12,513,55939,50458,5481,357173,0,12172,52190,11088,1101,13031,5497,5497,.13434248,,.060301509,198,0,,,,,
2020-09-20,62,62,0,405,0,0,3,5,58,20,20,194,56001,50520,5481,357578,0,12172,52384,11091,1106,13089,5517,5517,.15308642,,,199,0,,,,,
2020-09-21,447,422,25,2847,0,219,51,4,29,13,13,838,56448,50942,5506,360425,0,12391,53222,11142,1110,13118,5530,5530,.15700738,,.11415525,200,0,,,,,
2020-09-22,368,342,26,2450,0,231,44,4,18,5,5,672,56816,51284,5532,362875,0,12622,53894,11186,1114,13136,5535,5535,.15020408,,.11255411,201,0,,,,,
2020-09-23,435,412,23,2899,0,171,40,4,20,13,13,593,57251,51696,5555,365774,0,12793,54487,11226,1118,13156,5548,5548,.15005174,,.13450292,202,0,,,,,
2020-09-24,414,391,23,2461,0,133,55,8,25,17,17,417,57665,52087,5578,368235,0,12926,54904,11281,1126,13181,5565,5565,.1682243,,.17293233,203,0,,,,,
2020-09-25,450,430,20,3165,0,137,49,6,24,9,9,367,58115,52517,5598,371400,0,13063,55271,11330,1132,13205,5574,5574,.1421801,,.14598539,204,0,,,,,
2020-09-26,294,289,5,2252,0,62,32,7,16,10,10,297,58409,52806,5603,373652,0,13125,55568,11362,1139,13221,5584,5584,.13055062,,.080645159,205,0,,,,,
2020-09-27,41,41,0,393,0,0,2,3,14,8,8,78,58450,52847,5603,374045,0,13125,55646,11364,1142,13235,5592,5592,.1043257,,,206,0,,,,,
2020-09-28,327,309,18,2784,0,77,42,6,12,4,4,471,58777,53156,5621,376829,0,13202,56117,11406,1148,13247,5596,5596,.1174569,,.23376623,207,0,,,,,
2020-09-29,533,516,17,2933,0,119,63,4,12,3,3,367,59310,53672,5638,379762,0,13321,56484,11469,1152,13259,5599,5599,.18172519,,.14285715,208,0,,,,,
2020-09-30,458,440,18,2970,0,111,29,3,20,9,9,425,59768,54112,5656,382732,0,13432,56909,11498,1155,13279,5608,5608,.15420875,,.16216215,209,0,,,,,
2020-10-01,458,447,11,2857,0,135,34,6,41,9,9,400,60226,54559,5667,385589,0,13567,57309,11532,1161,13320,5617,5617,.16030802,,.081481479,210,0,,,,,
2020-10-02,415,405,10,2514,0,99,26,4,27,6,6,436,60641,54964,5677,388103,0,13666,57745,11558,1165,13347,5623,5623,.16507557,,.1010101,211,0,,,,,
2020-10-03,406,403,3,2242,0,65,21,2,18,4,4,306,61047,55367,5680,390345,0,13731,58051,11579,1167,13365,5627,5627,.18108831,,.046153847,212,0,,,,,
2020-10-04,100,100,0,507,0,0,7,1,7,1,1,47,61147,55467,5680,390852,0,13731,58098,11586,1168,13372,5628,5628,.19723865,,,213,0,,,,,
2020-10-05,296,289,7,2006,0,89,23,3,21,4,4,350,61443,55756,5687,392858,0,13820,58448,11609,1171,13393,5632,5632,.14755733,,.078651689,214,0,,,,,
2020-10-06,233,211,22,1705,0,85,30,3,12,5,5,546,61676,55967,5709,394563,0,13905,58994,11639,1174,13405,5637,5637,.1366569,,.25882354,215,0,,,,,
2020-10-07,193,187,6,1663,0,86,21,1,12,1,1,456,61869,56154,5715,396226,0,13991,59450,11660,1175,13417,5638,5638,.11605532,,.069767445,216,0,,,,,
2020-10-08,400,396,4,2813,0,97,21,4,11,3,3,462,62269,56550,5719,399039,0,14088,59912,11681,1179,13428,5641,5641,.14219694,,.041237112,217,0,,,,,
2020-10-09,497,495,2,3372,0,39,28,0,10,2,2,435,62766,57045,5721,402411,0,14127,60347,11709,1179,13438,5643,5643,.14739028,,.051282052,218,0,,,,,
2020-10-10,535,531,4,3208,0,75,49,1,24,7,7,400,63301,57576,5725,405619,0,14202,60747,11758,1180,13462,5650,5650,.16677058,,.053333335,219,0,,,,,
2020-10-11,60,60,0,597,0,1,7,1,14,4,4,97,63361,57636,5725,406216,0,14203,60844,11765,1181,13476,5654,5654,.10050251,,0,220,0,,,,,
2020-10-12,911,907,4,3521,0,64,42,1,19,3,3,310,64272,58543,5729,409737,0,14267,61154,11807,1182,13495,5657,5657,.2587333,,.0625,221,0,,,,,
2020-10-13,580,573,7,2345,0,88,51,3,14,6,6,247,64852,59116,5736,412082,0,14355,61401,11858,1185,13509,5663,5663,.24733475,,.079545453,222,0,,,,,
2020-10-14,391,385,6,2351,0,54,30,2,11,4,4,242,65243,59501,5742,414433,0,14409,61643,11888,1187,13520,5667,5667,.1663122,,.11111111,223,0,,,,,
2020-10-15,343,341,2,2137,0,74,22,0,25,11,11,427,65586,59842,5744,416570,0,14483,62070,11910,1187,13545,5678,5678,.16050538,,.027027028,224,0,,,,,
2020-10-16,326,321,5,2210,0,96,22,3,20,10,10,505,65912,60163,5749,418780,0,14579,62575,11932,1190,13565,5688,5688,.14751132,,.052083332,225,0,,,,,
2020-10-17,150,150,0,1484,0,38,11,3,12,7,7,536,66062,60313,5749,420264,0,14617,63111,11943,1193,13577,5695,5695,.10107817,,0,226,0,,,,,
2020-10-18,59,47,12,409,0,13,7,5,8,4,4,61,66121,60360,5761,420673,0,14630,63172,11950,1198,13585,5699,5699,.14425428,,.92307693,227,0,,,,,
2020-10-19,234,230,4,1717,0,46,16,7,7,4,4,790,66355,60590,5765,422390,0,14676,63962,11966,1205,13592,5703,5703,.13628422,,.086956523,228,0,,,,,
2020-10-20,328,317,11,2237,0,87,31,1,31,10,10,523,66683,60907,5776,424627,0,14763,64485,11997,1206,13623,5713,5713,.14662494,,.12643678,229,0,,,,,
2020-10-21,194,179,15,1402,0,94,33,2,12,5,5,361,66877,61086,5791,426029,0,14857,64846,12030,1208,13635,5718,5718,.13837375,,.15957446,230,0,,,,,
2020-10-22,271,258,13,1823,0,59,25,2,11,5,5,314,67148,61344,5804,427852,0,14916,65160,12055,1210,13646,5723,5723,.14865606,,.22033899,231,0,,,,,
2020-10-23,224,223,1,1788,0,41,11,2,4,1,1,324,67372,61567,5805,429640,0,14957,65484,12066,1212,13650,5724,5724,.12527964,,.024390243,232,0,,,,,
2020-10-24,188,185,3,1394,0,25,17,3,9,2,2,165,67560,61752,5808,431034,0,14982,65649,12083,1215,13659,5726,5726,.1348637,,.12,233,0,,,,,
2020-10-25,31,31,0,342,0,0,3,2,19,0,0,47,67591,61783,5808,431376,0,14982,65696,12086,1217,13678,5726,5726,.090643272,,,234,0,,,,,
2020-10-26,257,246,11,1620,0,60,25,1,22,4,4,370,67848,62029,5819,432996,0,15042,66066,12111,1218,13700,5730,5730,.15864198,,.18333334,235,0,,,,,
2020-10-27,207,206,1,1551,0,59,16,2,7,2,2,393,68055,62235,5820,434547,0,15101,66459,12127,1220,13707,5732,5732,.13346228,,.016949153,236,0,,,,,
2020-10-28,195,189,6,1458,0,74,19,5,12,2,2,209,68250,62424,5826,436005,0,15175,66668,12146,1225,13719,5734,5734,.13374485,,.081081077,237,1,,,,,
2020-10-29,191,189,2,1281,0,64,13,3,14,4,4,292,68441,62613,5828,437286,0,15239,66960,12159,1228,13733,5738,5738,.14910227,,.03125,238,0,,,,,
2020-10-30,182,182,0,1561,0,71,13,2,22,9,9,245,68623,62795,5828,438847,0,15310,67205,12172,1230,13755,5747,5747,.11659193,,0,239,0,,,,,
2020-10-31,144,142,2,1456,0,46,17,0,5,3,3,193,68767,62937,5830,440303,0,15356,67398,12189,1230,13760,5750,5750,.0989011,,.043478262,240,0,,,,,
2020-11-01,51,51,0,388,0,0,11,2,29,5,5,42,68818,62988,5830,440691,0,15356,67440,12200,1232,13789,5755,5755,.13144329,,,241,0,,,,,
2020-11-02,166,163,3,1349,0,62,13,1,13,4,4,245,68984,63151,5833,442040,0,15418,67685,12213,1233,13802,5759,5759,.12305412,,.048387095,242,0,,,,,
2020-11-03,290,278,12,2298,0,39,38,1,9,2,2,222,69274,63429,5845,444338,0,15457,67907,12251,1234,13811,5761,5761,.1261967,,.30769232,243,0,,,,,
2020-11-04,254,253,1,1996,0,34,29,2,5,1,1,201,69528,63682,5846,446334,0,15491,68108,12280,1236,13816,5762,5762,.12725452,,.029411765,244,0,,,,,
2020-11-05,221,214,7,1847,0,93,25,1,13,3,3,207,69749,63896,5853,448181,0,15584,68315,12305,1237,13829,5765,5765,.11965349,,.07526882,245,0,,,,,
2020-11-06,246,244,2,1922,0,46,13,2,15,10,10,179,69995,64140,5855,450103,0,15630,68494,12318,1239,13844,5775,5775,.12799168,,.043478262,246,0,,,,,
2020-11-07,238,236,2,1468,0,34,18,1,17,8,8,151,70233,64376,5857,451571,0,15664,68645,12336,1240,13861,5783,5783,.16212533,,.05882353,247,0,,,,,
2020-11-08,285,283,2,1605,0,36,27,2,8,3,3,49,70518,64659,5859,453176,0,15700,68694,12363,1242,13869,5786,5786,.17757009,,.055555556,248,0,,,,,
2020-11-09,152,151,1,1526,0,47,13,1,12,7,7,176,70670,64810,5860,454702,0,15747,68870,12376,1243,13881,5793,5793,.099606812,,.021276595,249,0,,,,,
2020-11-10,196,195,1,1902,0,96,15,1,21,8,8,262,70866,65005,5861,456604,0,15843,69132,12391,1244,13902,5801,5801,.10304942,,.010416667,250,0,,,,,
2020-11-11,167,165,2,1623,0,120,10,2,17,6,6,243,71033,65170,5863,458227,0,15963,69375,12401,1246,13919,5807,5807,.10289587,,.016666668,251,0,,,,,
2020-11-12,168,160,8,1500,0,155,16,4,13,6,6,211,71201,65330,5871,459727,0,16118,69586,12417,1250,13932,5813,5813,.112,,.051612902,252,0,,,,,
2020-11-13,183,181,2,1648,0,140,13,0,9,6,6,242,71384,65511,5873,461375,0,16258,69828,12430,1250,13941,5819,5819,.11104369,,.014285714,253,0,,,,,
2020-11-14,133,129,4,1759,0,214,17,1,13,3,3,220,71517,65640,5877,463134,0,16472,70048,12447,1251,13954,5822,5822,.075611144,,.018691588,254,0,,,,,
2020-11-15,40,40,0,381,0,2,3,1,18,7,7,258,71557,65680,5877,463515,0,16474,70306,12450,1252,13972,5829,5829,.10498688,,0,255,0,,,,,
2020-11-16,178,170,8,1600,0,232,17,1,18,5,5,158,71735,65850,5885,465115,0,16706,70464,12467,1253,13990,5834,5834,.11125,,.034482758,256,0,,,,,
2020-11-17,170,169,1,1764,0,229,6,4,11,6,6,219,71905,66019,5886,466879,0,16935,70683,12473,1257,14001,5840,5840,.096371882,,.0043668123,257,0,,,,,
2020-11-18,155,146,9,1421,0,229,19,1,8,2,2,175,72060,66165,5895,468300,0,17164,70858,12492,1258,14009,5842,5842,.10907812,,.03930131,258,0,,,,,
2020-11-19,130,118,12,1361,0,163,27,1,11,7,7,169,72190,66283,5907,469661,0,17327,71027,12519,1259,14020,5849,5849,.095518,,.073619634,259,0,,,,,
2020-11-20,157,142,15,1373,0,115,26,0,25,18,18,183,72347,66425,5922,471034,0,17442,71210,12545,1259,14045,5867,5867,.11434814,,.13043478,260,0,,,,,
2020-11-21,123,117,6,1354,0,34,8,1,9,6,6,148,72470,66542,5928,472388,0,17476,71358,12553,1260,14054,5873,5873,.090841949,,.17647059,261,0,,,,,
2020-11-22,97,97,0,545,0,0,20,0,13,6,6,68,72567,66639,5928,472933,0,17476,71426,12573,1260,14067,5879,5879,.17798164,,,262,0,,,,,
2020-11-23,156,149,7,1368,0,59,23,2,17,10,10,158,72723,66788,5935,474301,0,17535,71584,12596,1262,14084,5889,5889,.11403508,,.11864407,263,0,,,,,
2020-11-24,200,195,5,1811,0,61,16,1,9,7,7,173,72923,66983,5940,476112,0,17596,71757,12612,1263,14093,5896,5896,.11043622,,.081967212,264,0,,,,,
2020-11-25,191,182,9,1499,0,72,14,2,7,4,4,148,73114,67165,5949,477611,0,17668,71905,12626,1265,14100,5900,5900,.12741828,,.125,265,0,,,,,
2020-11-26,145,132,13,1623,0,61,20,2,7,2,2,131,73259,67297,5962,479234,0,17729,72036,12646,1267,14107,5902,5902,.089340724,,.21311475,266,0,,,,,
2020-11-27,274,253,21,2055,0,71,30,0,12,7,7,148,73533,67550,5983,481289,0,17800,72184,12676,1267,14119,5909,5909,.13333334,,.29577464,267,0,,,,,
2020-11-28,274,270,4,2016,0,51,11,0,13,9,9,122,73807,67820,5987,483305,0,17851,72306,12687,1267,14132,5918,5918,.1359127,,.078431375,268,0,,,,,
2020-11-29,27,27,0,311,0,2,8,2,11,7,7,90,73834,67847,5987,483616,0,17853,72396,12695,1269,14143,5925,5925,.086816721,,0,269,0,,,,,
2020-11-30,161,151,10,1490,0,62,19,0,14,9,9,164,73995,67998,5997,485106,0,17915,72560,12714,1269,14157,5934,5934,.10805369,,.16129032,270,0,,,,,
2020-12-01,136,117,19,1400,0,60,27,0,21,8,8,198,74131,68115,6016,486506,0,17975,72758,12741,1269,14178,5942,5942,.09714286,,.31666666,271,0,,,,,
2020-12-02,134,131,3,1563,0,38,12,4,4,3,3,201,74265,68246,6019,488069,0,18013,72959,12753,1273,14182,5945,5945,.085732564,,.078947365,272,0,,,,,
2020-12-03,98,88,10,1208,0,41,19,1,10,4,4,136,74363,68334,6029,489277,0,18054,73095,12772,1274,14192,5949,5949,.081125826,,.24390244,273,0,,,,,
2020-12-04,152,134,18,1378,0,63,31,3,10,3,3,259,74515,68468,6047,490655,0,18117,73354,12803,1277,14202,5952,5952,.11030479,,.2857143,274,0,,,,,
2020-12-05,117,115,2,1139,0,57,9,2,15,5,5,256,74632,68583,6049,491794,0,18174,73610,12812,1279,14217,5957,5957,.10272168,,.03508772,275,0,,,,,
2020-12-06,37,37,0,287,0,1,2,0,6,1,1,35,74669,68620,6049,492081,0,18175,73645,12814,1279,14223,5958,5958,.12891985,,0,276,0,,,,,
2020-12-07,111,107,4,1054,0,70,14,1,12,9,9,157,74780,68727,6053,493135,0,18245,73802,12828,1280,14235,5967,5967,.10531309,,.057142857,277,0,,,,,
2020-12-08,73,67,6,795,0,75,10,1,9,7,7,119,74853,68794,6059,493930,0,18320,73921,12838,1281,14244,5974,5974,.091823898,,.079999998,278,0,,,,,
2020-12-09,132,129,3,1498,0,30,11,3,9,5,5,142,74985,68923,6062,495428,0,18350,74063,12849,1284,14253,5979,5979,.088117488,,.1,279,0,,,,,
2020-12-10,110,105,5,1324,0,57,15,2,14,11,11,113,75095,69028,6067,496752,0,18407,74176,12864,1286,14267,5990,5990,.083081573,,.087719299,280,0,,,,,
2020-12-11,218,213,5,1706,0,71,18,1,14,11,11,151,75313,69241,6072,498458,0,18478,74327,12882,1287,14281,6001,6001,.1277843,,.070422538,281,0,,,,,
2020-12-12,159,147,12,1236,0,49,20,1,13,8,8,125,75472,69388,6084,499694,0,18527,74452,12902,1288,14294,6009,6009,.12864077,,.24489796,282,0,,,,,
2020-12-13,32,32,0,292,0,1,4,0,15,9,9,38,75504,69420,6084,499986,0,18528,74490,12906,1288,14309,6018,6018,.10958904,,0,283,0,,,,,
2020-12-14,108,97,11,1127,0,61,26,3,19,14,14,120,75612,69517,6095,501113,0,18589,74610,12932,1291,14328,6032,6032,.095829636,,.18032786,284,0,,,,,
2020-12-15,217,213,4,2074,0,88,24,3,28,20,20,101,75829,69730,6099,503187,0,18677,74711,12956,1294,14356,6052,6052,.10462873,,.045454547,285,0,,,,,
2020-12-16,318,312,6,1935,0,52,18,2,18,12,12,127,76147,70042,6105,505122,0,18729,74838,12974,1296,14374,6064,6064,.16434109,,.11538462,286,0,,,,,
2020-12-17,200,180,20,1818,0,109,28,2,19,19,19,102,76347,70222,6125,506940,0,18838,74940,13002,1298,14393,6083,6083,.110011,,.18348624,287,0,,,,,
2020-12-18,284,272,12,2231,0,81,22,0,17,12,12,239,76631,70494,6137,509171,0,18919,75179,13024,1298,14410,6095,6095,.12729718,,.14814815,288,0,,,,,
2020-12-19,316,307,9,2394,0,32,18,0,11,7,7,156,76947,70801,6146,511565,0,18951,75335,13042,1298,14421,6102,6102,.13199666,,.28125,289,0,,,,,
2020-12-20,45,45,0,333,0,0,2,0,14,9,9,29,76992,70846,6146,511898,0,18951,75364,13044,1298,14435,6111,6111,.13513513,,,290,0,,,,,
2020-12-21,129,103,26,1173,0,88,35,2,13,9,9,109,77121,70949,6172,513071,0,19039,75473,13079,1300,14448,6120,6120,.10997442,,.29545453,291,0,,,,,
2020-12-22,63,56,7,1052,0,61,10,4,20,15,15,178,77184,71005,6179,514123,0,19100,75651,13089,1304,14468,6135,6135,.05988593,,.1147541,292,0,,,,,
2020-12-23,112,82,30,994,0,84,33,3,28,26,26,290,77296,71087,6209,515117,0,19184,75941,13122,1307,14496,6161,6161,.11267605,,.35714287,293,0,,,,,
2020-12-24,67,59,8,461,0,40,13,1,29,21,21,184,77363,71146,6217,515578,0,19224,76125,13135,1308,14525,6182,6182,.14533623,,.2,294,0,,,,,
2020-12-25,26,26,0,168,0,0,0,2,23,20,20,264,77389,71172,6217,515746,0,19224,76389,13135,1310,14548,6202,6202,.15476191,,,295,0,,,,,
2020-12-26,76,59,17,773,0,60,18,0,27,17,17,306,77465,71231,6234,516519,0,19284,76695,13153,1310,14575,6219,6219,.098318242,,.28333333,296,0,,,,,
2020-12-27,32,32,0,238,0,0,3,0,15,9,9,43,77497,71263,6234,516757,0,19284,76738,13156,1310,14590,6228,6228,.13445379,,,297,0,,,,,
2020-12-28,108,94,14,886,0,58,21,4,39,27,27,114,77605,71357,6248,517643,0,19342,76852,13177,1314,14629,6255,6255,.12189616,,.24137931,298,0,,,,,
2020-12-29,130,97,33,1093,0,86,35,0,28,19,19,92,77735,71454,6281,518736,0,19428,76944,13212,1314,14657,6274,6274,.1189387,,.38372093,299,0,,,,,
2020-12-30,75,53,22,837,0,70,26,1,39,26,26,118,77810,71507,6303,519573,0,19498,77062,13238,1315,14696,6300,6300,.089605734,,.31428573,300,0,,,,,
2020-12-31,71,46,25,755,0,98,29,1,29,22,22,95,77881,71553,6328,520328,0,19596,77157,13267,1316,14725,6322,6322,.094039738,,.25510204,301,0,,,,,
2021-01-01,46,28,18,300,0,83,26,1,68,45,45,66,77927,71581,6346,520628,0,19679,77223,13293,1317,14793,6367,6367,.15333334,,.21686748,302,0,,,,,
2021-01-02,63,59,4,639,0,34,6,0,51,28,28,88,77990,71640,6350,521267,0,19713,77311,13299,1317,14844,6395,6395,.098591551,,.11764706,303,0,,,,,
2021-01-03,33,33,0,319,0,0,3,2,47,35,35,36,78023,71673,6350,521586,0,19713,77347,13302,1319,14891,6430,6430,.10344828,,,304,0,,,,,
2021-01-04,140,110,30,1219,0,138,37,1,55,39,39,113,78163,71783,6380,522805,0,19851,77460,13339,1320,14946,6469,6469,.11484823,,.2173913,305,0,,,,,
2021-01-05,109,89,20,1111,0,89,33,1,44,31,31,99,78272,71872,6400,523916,0,19940,77559,13372,1321,14990,6500,6500,.098109812,,.22471911,306,0,,,,,
2021-01-06,147,97,50,1260,0,156,62,1,55,40,40,86,78419,71969,6450,525176,0,20096,77645,13434,1322,15045,6540,6540,.11666667,,.32051283,307,0,,,,,
2021-01-07,148,118,30,1484,0,153,38,5,56,36,36,52,78567,72087,6480,526660,0,20249,77697,13472,1327,15101,6576,6576,.099730462,,.19607843,308,0,,,,,
2021-01-08,188,145,43,1385,0,139,63,9,82,59,59,20,78755,72232,6523,528045,0,20388,77717,13535,1336,15183,6635,6635,.13574007,,.30935252,309,0,,,,,
2021-01-09,135,111,24,1563,0,136,37,3,65,49,49,76,78890,72343,6547,529608,0,20524,77793,13572,1339,15248,6684,6684,.086372361,,.17647059,310,0,,,,,
2021-01-10,59,59,0,425,0,1,8,4,122,86,86,30,78949,72402,6547,530033,0,20525,77823,13580,1343,15370,6770,6770,.13882352,,0,311,0,,,,,
2021-01-11,168,137,31,1407,0,135,52,4,74,58,58,119,79117,72539,6578,531440,0,20660,77942,13632,1347,15444,6828,6828,.11940298,,.22962964,312,0,,,,,
2021-01-12,163,115,48,1591,0,298,69,2,86,60,60,127,79280,72654,6626,533031,0,20958,78069,13701,1349,15530,6888,6888,.10245129,,.16107382,313,0,,,,,
2021-01-13,165,102,63,1251,0,187,82,7,67,45,45,117,79445,72756,6689,534282,0,21145,78186,13783,1356,15597,6933,6933,.13189448,,.33689839,314,0,,,,,
2021-01-14,199,147,52,1489,0,184,77,5,68,48,48,130,79644,72903,6741,535771,0,21329,78316,13860,1361,15665,6981,6981,.13364674,,.28260869,315,0,,,,,
2021-01-15,403,359,44,2520,0,221,76,4,112,77,77,146,80047,73262,6785,538291,0,21550,78462,13936,1365,15777,7058,7058,.15992063,,.19909503,316,0,,,,,
2021-01-16,302,199,103,2019,0,358,129,6,84,65,65,106,80349,73461,6888,540310,0,21908,78568,14065,1371,15861,7123,7123,.149579,,.2877095,317,0,,,,,
2021-01-17,70,65,5,454,0,5,29,5,91,68,68,57,80419,73526,6893,540764,0,21913,78625,14094,1376,15952,7191,7191,.15418503,,1,318,0,,,,,
2021-01-18,272,189,83,1476,0,295,108,8,132,87,87,158,80691,73715,6976,542240,0,22208,78783,14202,1384,16084,7278,7278,.18428184,,.28135592,319,0,,,,,
2021-01-19,204,154,50,1362,0,188,85,6,92,75,75,143,80895,73869,7026,543602,0,22396,78926,14287,1390,16176,7353,7353,.14977974,,.26595744,320,0,,,,,
2021-01-20,319,210,109,1723,0,287,153,7,139,106,106,154,81214,74079,7135,545325,0,22683,79080,14440,1397,16315,7459,7459,.18514219,,.37979093,321,0,,,,,
2021-01-21,274,222,52,1910,0,439,121,12,89,73,73,179,81488,74301,7187,547235,0,23122,79259,14561,1409,16404,7532,7532,.14345549,,.11845102,322,0,,,,,
2021-01-22,290,208,82,1876,0,232,146,9,84,68,68,395,81778,74509,7269,549111,0,23354,79654,14707,1418,16488,7600,7600,.15458423,,.35344827,323,0,,,,,
2021-01-23,267,143,124,1301,0,316,170,10,83,68,68,234,82045,74652,7393,550412,0,23670,79888,14877,1428,16571,7668,7668,.20522675,,.39240506,324,0,,,,,
2021-01-24,90,87,3,508,0,3,27,3,83,72,72,71,82135,74739,7396,550920,0,23673,79959,14904,1431,16654,7740,7740,.17716536,,1,325,0,,,,,
2021-01-25,226,221,5,1715,0,5,100,11,81,69,69,232,82361,74960,7401,552635,0,23678,80191,15004,1442,16735,7809,7809,.13177842,,1,326,0,,,,,
2021-01-26,239,169,70,1937,0,177,139,8,71,62,62,198,82600,75129,7471,554572,0,23855,80389,15143,1450,16806,7871,7871,.12338668,,.39548022,327,0,,,,,
2021-01-27,370,212,158,2144,0,333,266,10,43,40,40,271,82970,75341,7629,556716,0,24188,80660,15409,1460,16849,7911,7911,.17257462,,.47447446,328,0,,,,,
2021-01-28,271,170,101,2052,0,237,221,13,26,21,21,274,83241,75511,7730,558768,0,24425,80934,15630,1473,16875,7932,7932,.13206628,,.42616034,329,0,,,,,
2021-01-29,321,181,140,2397,0,277,234,11,12,10,10,266,83562,75692,7870,561165,0,24702,81200,15864,1484,16887,7942,7942,.13391739,,.50541514,330,0,,,,,
2021-01-30,203,153,50,2589,0,91,156,8,2,2,2,265,83765,75845,7920,563754,0,24793,81465,16020,1492,16889,7944,7944,.078408651,,.54945058,331,0,,,,,
2021-01-31,162,62,100,879,0,196,145,13,3,2,2,96,83927,75907,8020,564633,0,24989,81561,16165,1505,16892,7946,7946,.18430035,,.51020408,332,0,,,,,
2021-02-01,262,167,95,2822,0,139,246,9,1,1,1,325,84189,76074,8115,567455,0,25128,81886,16411,1514,16893,7947,7947,.092841953,,.68345326,333,0,,,,,
2021-02-02,202,147,55,1984,0,116,167,8,0,0,0,274,84391,76221,8170,569439,0,25244,82160,16578,1522,16893,7947,7947,.10181452,,.47413793,334,0,,,,,
2021-02-03,30,30,0,764,0,0,29,3,0,0,0,350,84421,76251,8170,570203,0,25244,82510,16607,1525,16893,7947,7947,.039267015,,,335,0,,,,,
2021-02-04,,,,,,,,,,,,313,84421,76251,8170,570203,0,25244,82823,16607,1525,16893,7947,7947,,,,336,,,,,,
2021-02-05,,,,,,,,,,,,324,84421,76251,8170,570203,0,25244,83147,16607,1525,16893,7947,7947,,,,337,,,,,,
2021-02-06,,,,,,,,,,,,330,84421,76251,8170,570203,0,25244,83477,16607,1525,16893,7947,7947,,,,338,,,,,,
2021-02-07,,,,,,,,,,,,70,84421,76251,8170,570203,0,25244,83547,16607,1525,16893,7947,7947,,,,339,,,,,,
2021-02-08,,,,,,,,,,,,298,84421,76251,8170,570203,0,25244,83845,16607,1525,16893,7947,7947,,,,340,,,,,,
2021-02-09,,,,,,,,,,,,310,84421,76251,8170,570203,0,25244,84155,16607,1525,16893,7947,7947,,,,341,,,,,,
2021-02-10,,,,,,,,,,,,393,84421,76251,8170,570203,0,25244,84548,16607,1525,16893,7947,7947,,,,342,,,,,,
2021-02-11,,,,,,,,,,,,279,84421,76251,8170,570203,0,25244,84827,16607,1525,16893,7947,7947,,,,343,,,,,,
2021-02-12,,,,,,,,,,,,300,84421,76251,8170,570203,0,25244,85127,16607,1525,16893,7947,7947,,,,344,,,,,,
2021-02-13,,,,,,,,,,,,247,84421,76251,8170,570203,0,25244,85374,16607,1525,16893,7947,7947,,,,345,,,,,,
2021-02-14,,,,,,,,,,,,185,84421,76251,8170,570203,0,25244,85559,16607,1525,16893,7947,7947,,,,346,,,,,,
2021-02-15,,,,,,,,,,,,357,84421,76251,8170,570203,0,25244,85916,16607,1525,16893,7947,7947,,,,347,,,,,,
2021-02-16,,,,,,,,,,,,237,84421,76251,8170,570203,0,25244,86153,16607,1525,16893,7947,7947,,,,348,,,,,,
2021-02-17,,,,,,,,,,,,86,84421,76251,8170,570203,0,25244,86239,16607,1525,16893,7947,7947,,,,349,,,,,,
2021-02-28,,,,,,,,,0,0,0,,84421,76251,8170,570203,0,25244,86239,16607,1525,16893,7947,7947,,,,350,,,,,,
,0,0,0,2,0,1,0,1,0,0,0,0,84421,76251,8170,570205,0,25245,86239,16607,1526,16893,7947,7947,0,,0,351,0,0,1,1,0,0
