fecha,positivo,positivo_rapida,positivo_molecular,muestra,muestra_rapida,muestra_molecular,sintomaticos,defunciones,inicio,inicio_molecular,inicio_rapida,recuperado,total_positivo,total_positivo_rapida,total_positivo_molecular,total_muestra,total_muestra_rapida,total_muestra_molecular,total_recuperado,total_sintomaticos,total_defunciones,total_inicio,total_inicio_molecular,total_inicio_rapida,posi,posi_rapida,posi_molecular,dias,primera_ola_positivo,segunda_ola_positivo,primera_ola_defunciones,segunda_ola_defunciones,primera_ola_tasamolecular,segunda_ola_tasamolecular
2020-03-06,,,,,,,,,1,1,1,,0,0,0,0,0,0,0,0,0,1,1,1,,,,1,,98,1,4,.19875777,.18518518
2020-03-07,,,,,,,,,2,1,1,,0,0,0,0,0,0,0,0,0,3,2,2,,,,2,,152,1,4,.18181819,.15000001
2020-03-08,,,,,,,,,1,1,1,,0,0,0,0,0,0,0,0,0,4,3,3,,,,3,,117,3,2,.22368421,.28125
2020-03-09,,,,,,,,,1,1,1,,0,0,0,0,0,0,0,0,0,5,4,4,,,,4,,37,2,7,,
2020-03-10,,,,,,,,,2,2,2,,0,0,0,0,0,0,0,0,0,7,6,6,,,,5,,111,0,5,.21649484,.29545453
2020-03-11,,,,,,,,,0,0,0,,0,0,0,0,0,0,0,0,0,7,6,6,,,,6,,73,3,4,.090909094,.11666667
2020-03-12,,,,,,,,,0,0,0,,0,0,0,0,0,0,0,0,0,7,6,6,,,,7,,132,3,6,.14423077,.35714287
2020-03-13,1,0,1,3,0,3,1,0,0,0,0,,1,0,1,3,0,3,0,1,0,7,6,6,.33333334,,.33333334,8,0,110,5,5,.1171875,.2
2020-03-14,0,0,0,1,0,0,0,0,2,1,1,,1,0,1,4,0,3,0,1,0,9,7,7,0,,,9,0,218,7,8,.11494253,
2020-03-15,0,0,0,21,0,18,0,0,4,3,3,,1,0,1,25,0,21,0,1,0,13,10,10,0,,0,10,0,159,1,6,.060301509,.28333333
2020-03-16,0,0,0,2,0,2,0,0,3,2,2,,1,0,1,27,0,23,0,1,0,16,12,12,0,,0,11,0,32,2,7,,
2020-03-17,0,0,0,1,0,1,0,0,4,2,2,,1,0,1,28,0,24,0,1,0,20,14,14,0,,0,12,0,108,2,12,.11520737,.24137931
2020-03-18,3,0,3,16,0,16,3,0,5,4,4,,4,0,4,44,0,40,0,4,0,25,18,18,.1875,,.1875,13,0,217,2,9,.11304348,.38372093
2020-03-19,0,0,0,3,0,1,0,0,2,2,2,,4,0,4,47,0,41,0,4,0,27,20,20,0,,0,14,0,319,3,10,.13529412,.31884059
2020-03-20,1,1,0,16,0,14,0,0,7,5,5,,5,1,4,63,0,55,0,4,0,34,25,25,.0625,,0,15,0,200,2,3,.17293233,.25510204
2020-03-21,0,0,0,12,0,12,0,0,4,3,3,,5,1,4,75,0,67,0,4,0,38,28,28,0,,0,16,0,284,1,11,.14598539,.20689656
2020-03-22,3,1,2,5,0,4,2,0,4,3,3,,8,2,6,80,0,71,0,6,0,42,31,31,.60000002,,.5,17,0,316,2,8,.080645159,.11111111
2020-03-23,0,0,0,19,0,19,0,0,3,2,2,,8,2,6,99,0,90,0,6,0,45,33,33,0,,0,18,0,45,5,10,,
2020-03-24,4,0,4,14,0,13,4,1,8,7,7,,12,2,10,113,0,103,0,10,1,53,40,40,.2857143,,.30769232,19,0,129,3,13,.23684211,.21428572
2020-03-25,1,1,0,2,0,0,0,0,6,6,6,,13,3,10,115,0,103,0,10,1,59,46,46,.5,,,20,0,63,2,11,.14285715,.22471911
2020-03-26,0,0,0,1,0,1,0,0,5,4,4,,13,3,10,116,0,104,0,10,1,64,50,50,0,,0,21,0,112,0,8,.16216215,.32051283
2020-03-27,2,0,2,20,0,19,2,1,5,4,4,2,15,3,12,136,0,123,2,12,2,69,54,54,.1,,.10526316,22,0,67,2,13,.081481479,.19607843
2020-03-28,16,0,16,33,0,32,16,0,2,1,1,,31,3,28,169,0,155,2,28,2,71,55,55,.4848485,,.5,23,0,26,1,9,.10204082,.30935252
2020-03-29,0,0,0,1,0,0,0,0,4,2,2,,31,3,28,170,0,155,2,28,2,75,57,57,0,,,24,0,76,1,8,.046875,.17647059
2020-03-30,6,0,6,27,0,24,6,0,4,2,2,,37,3,34,197,0,179,2,34,2,79,59,59,.22222222,,.25,25,0,32,2,13,,0
2020-03-31,4,0,4,26,0,26,4,0,3,3,3,,41,3,38,223,0,205,2,38,2,82,62,62,.15384616,,.15384616,26,0,108,1,11,.079545453,.23134328
2020-04-01,1,1,0,3,0,0,0,0,10,0,0,4,42,4,38,226,0,205,6,38,2,92,62,62,.33333334,,,27,0,130,2,12,.26190478,.15946844
2020-04-02,7,1,6,19,0,15,6,1,5,1,1,,49,5,44,245,0,220,6,44,3,97,63,63,.36842105,,.40000001,28,0,75,1,5,.069767445,.33689839
2020-04-03,4,0,4,18,0,17,4,0,4,1,1,,53,5,48,263,0,237,6,48,3,101,64,64,.22222222,,.23529412,29,0,71,2,,.041237112,.28191489
2020-04-04,12,8,4,654,0,8,5,0,7,3,3,,65,13,52,917,0,245,6,53,3,108,67,67,.018348623,,.5,30,0,46,1,,.051282052,.20091324
2020-04-05,2,0,2,37,0,17,2,0,7,2,2,3,67,13,54,954,0,262,9,55,3,115,69,69,.054054055,,.11764706,31,0,65,1,,.054054055,.28932583
2020-04-06,1,1,0,18,0,7,0,0,4,1,1,,68,14,54,972,0,269,9,55,3,119,70,70,.055555556,,0,32,0,33,2,,0,.71428573
2020-04-07,1,1,0,182,0,4,0,0,4,3,3,4,69,15,54,1154,0,273,13,55,3,123,73,73,.0054945056,,0,33,0,141,4,,.0625,.28522336
2020-04-08,5,3,2,20,0,11,4,0,2,0,0,1,74,18,56,1174,0,284,14,59,3,125,73,73,.25,,.18181819,34,0,109,0,,.079545453,.27127659
2020-04-09,2,0,2,49,0,10,2,0,2,2,2,,76,18,58,1223,0,294,14,61,3,127,75,75,.040816326,,.2,35,0,147,1,,.11111111,.38111889
2020-04-10,3,3,0,17,0,0,0,0,8,2,2,2,79,21,58,1240,0,294,16,61,3,135,77,77,.17647059,,,36,0,150,1,,.02739726,.11872146
2020-04-11,39,38,1,85,0,8,3,0,3,0,0,22,118,59,59,1325,0,302,38,64,3,138,77,77,.45882353,,.125,37,0,188,1,,.052083332,.3580786
2020-04-12,0,0,0,7,0,0,0,0,2,1,1,,118,59,59,1332,0,302,38,64,3,140,78,78,0,,,38,0,136,4,,0,.3936508
2020-04-13,1,0,1,47,0,7,0,0,2,0,0,6,119,59,60,1379,0,309,44,64,3,142,78,78,.021276595,,.14285715,39,0,59,1,,.92307693,1
2020-04-14,5,3,2,31,0,8,1,0,2,0,0,5,124,62,62,1410,0,317,49,65,3,144,78,78,.16129032,,.25,40,0,171,1,,.086956523,1
2020-04-15,1,1,0,157,0,0,0,0,11,1,1,3,125,63,62,1567,0,317,52,65,3,155,79,79,.0063694268,,,41,0,164,0,,.12643678,.39772728
2020-04-16,8,6,2,525,0,6,2,0,4,0,0,7,133,69,64,2092,0,323,59,67,3,159,79,79,.015238095,,.33333334,42,0,165,1,,.15957446,.47447446
2020-04-17,11,10,1,393,0,8,1,0,10,0,0,6,144,79,65,2485,0,331,65,68,3,169,79,79,.027989822,,.125,43,0,201,0,,.22033899,.42918456
2020-04-18,14,14,0,622,0,28,2,0,7,1,1,38,158,93,65,3107,0,359,103,70,3,176,80,80,.022508038,,0,44,0,402,2,,.024390243,.50359714
2020-04-19,0,0,0,326,0,0,0,0,8,1,1,2,158,93,65,3433,0,359,105,70,3,184,81,81,0,,,45,0,302,1,,.12,.55555558
2020-04-20,18,18,0,742,0,2,4,0,20,1,1,1,176,111,65,4175,0,361,106,74,3,204,82,82,.024258761,,0,46,0,69,2,,,.51282054
2020-04-21,6,6,0,502,0,11,3,0,13,0,0,3,182,117,65,4677,0,372,109,77,3,217,82,82,.011952192,,0,47,0,272,2,,.18333334,.64625853
2020-04-22,23,22,1,516,0,5,5,1,10,1,1,3,205,139,66,5193,0,377,112,82,4,227,83,83,.044573642,,.2,48,0,205,0,,.016949153,.49230769
2020-04-23,23,21,2,347,0,3,2,0,12,1,1,6,228,160,68,5540,0,380,118,84,4,239,84,84,.066282421,,.66666669,49,0,326,0,,.081081077,.42372882
2020-04-24,9,8,1,366,0,36,2,0,11,0,0,10,237,168,69,5906,0,416,128,86,4,250,84,84,.024590164,,.027777778,50,0,274,2,,.03125,.43352601
2020-04-25,13,13,0,239,0,8,1,0,8,0,0,18,250,181,69,6145,0,424,146,87,4,258,84,84,.054393306,,0,51,0,288,0,,0,.36923078
2020-04-26,0,0,0,18,0,7,0,0,2,1,1,,250,181,69,6163,0,431,146,87,4,260,85,85,0,,0,52,0,268,0,,.043478262,0
2020-04-27,14,14,0,240,0,13,2,0,9,2,2,16,264,195,69,6403,0,444,162,89,4,269,87,87,.058333334,,0,53,0,90,4,,,
2020-04-28,21,21,0,202,0,12,3,0,11,2,2,7,285,216,69,6605,0,456,169,92,4,280,89,89,.10396039,,0,54,0,228,1,,.049180329,
2020-04-29,23,21,2,425,0,29,9,0,10,0,0,11,308,237,71,7030,0,485,180,101,4,290,89,89,.054117646,,.068965517,55,0,241,3,,.30769232,
2020-04-30,39,39,0,423,0,12,10,0,12,0,0,14,347,276,71,7453,0,497,194,111,4,302,89,89,.092198581,,0,56,0,370,2,,.029411765,
2020-05-01,5,5,0,95,0,29,1,0,30,1,1,4,352,281,71,7548,0,526,198,112,4,332,90,90,.052631579,,0,57,0,272,0,,.07526882,
2020-05-02,16,16,0,170,0,4,4,0,12,2,2,13,368,297,71,7718,0,530,211,116,4,344,92,92,.094117649,,0,58,0,325,1,,.043478262,
2020-05-03,3,3,0,44,0,0,1,0,6,2,2,,371,300,71,7762,0,530,211,117,4,350,94,94,.06818182,,,59,0,212,1,,.05882353,
2020-05-04,11,10,1,440,0,21,4,0,9,2,2,16,382,310,72,8202,0,551,227,121,4,359,96,96,.025,,.047619049,60,0,164,3,,.055555556,
2020-05-05,29,29,0,663,0,22,4,0,20,3,3,22,411,339,72,8865,0,573,249,125,4,379,99,99,.043740574,,0,61,0,281,2,,.021276595,
2020-05-06,55,51,4,1016,0,11,7,0,16,3,3,25,466,390,76,9881,0,584,274,132,4,395,102,102,.054133859,,.36363637,62,0,229,1,,.010416667,
2020-05-07,47,44,3,552,0,11,7,1,9,2,2,49,513,434,79,10433,0,595,323,139,5,404,104,104,.08514493,,.27272728,63,0,190,1,,.016666668,
2020-05-08,48,47,1,680,0,16,8,0,4,0,0,9,561,481,80,11113,0,611,332,147,5,408,104,104,.070588239,,.0625,64,0,209,0,,.051948052,
2020-05-09,14,14,0,326,0,14,1,0,7,1,1,16,575,495,80,11439,0,625,348,148,5,415,105,105,.042944785,,0,65,0,192,3,,.014492754,
2020-05-10,2,2,0,98,0,0,1,1,16,0,0,3,577,497,80,11537,0,625,351,149,6,431,105,105,.020408163,,,66,0,10,3,,.018691588,
2020-05-11,63,63,0,852,0,15,5,0,10,1,1,9,640,560,80,12389,0,640,360,154,6,441,106,106,.07394366,,0,67,0,,2,,0,
2020-05-12,44,43,1,735,0,30,2,0,16,7,7,15,684,603,81,13124,0,670,375,156,6,457,113,113,.059863947,,.033333335,68,0,,2,,.034482758,
2020-05-13,76,74,2,1175,0,10,8,1,8,5,5,40,760,677,83,14299,0,680,415,164,7,465,118,118,.064680852,,.2,69,0,,0,,.0043668123,
2020-05-14,39,39,0,426,0,23,5,0,6,2,2,23,799,716,83,14725,0,703,438,169,7,471,120,120,.091549292,,0,70,0,,0,,.03930131,
2020-05-15,10,9,1,449,0,14,4,2,17,5,5,22,809,725,84,15174,0,717,460,173,9,488,125,125,.022271715,,.071428575,71,0,,0,,.073619634,
2020-05-16,16,16,0,399,0,29,1,0,12,5,5,7,825,741,84,15573,0,746,467,174,9,500,130,130,.04010025,,0,72,0,,2,,.13043478,
2020-05-17,1,1,0,62,0,0,0,0,11,3,3,1,826,742,84,15635,0,746,468,174,9,511,133,133,.016129032,,,73,0,,4,,.18181819,
2020-05-18,19,18,1,348,0,14,2,0,16,6,6,50,845,760,85,15983,0,760,518,176,9,527,139,139,.054597702,,.071428575,74,0,,3,,,
2020-05-19,53,53,0,944,0,18,3,1,6,3,3,34,898,813,85,16927,0,778,552,179,10,533,142,142,.056144066,,0,75,0,,1,,.12068965,
2020-05-20,37,36,1,711,0,15,3,0,17,4,4,69,935,849,86,17638,0,793,621,182,10,550,146,146,.052039381,,.06666667,76,0,,2,,.081967212,
2020-05-21,49,44,5,950,0,16,12,0,3,1,1,49,984,893,91,18588,0,809,670,194,10,553,147,147,.051578946,,.3125,77,0,,0,,.12857144,
2020-05-22,47,44,3,883,0,11,5,0,13,6,6,34,1031,937,94,19471,0,820,704,199,10,566,153,153,.053227633,,.27272728,78,0,,0,,.21311475,
2020-05-23,34,33,1,505,0,15,4,0,4,0,0,16,1065,970,95,19976,0,835,720,203,10,570,153,153,.067326732,,.06666667,79,0,,4,,.30000001,
2020-05-24,5,5,0,106,0,0,1,1,12,3,3,2,1070,975,95,20082,0,835,722,204,11,582,156,156,.047169812,,,80,0,,0,,.078431375,
2020-05-25,45,38,7,692,0,24,12,0,26,7,7,25,1115,1013,102,20774,0,859,747,216,11,608,163,163,.065028898,,.29166666,81,0,,1,,0,
2020-05-26,32,29,3,739,0,18,4,0,11,5,5,67,1147,1042,105,21513,0,877,814,220,11,619,168,168,.043301757,,.16666667,82,0,,1,,.16129032,
2020-05-27,46,44,2,1009,0,11,5,0,9,2,2,48,1193,1086,107,22522,0,888,862,225,11,628,170,170,.045589693,,.18181819,83,0,,1,,.31666666,
2020-05-28,53,53,0,943,0,1,5,0,15,3,3,42,1246,1139,107,23465,0,889,904,230,11,643,173,173,.056203604,,0,84,0,,0,,.078947365,
2020-05-29,66,62,4,835,0,23,6,0,16,12,12,27,1312,1201,111,24300,0,912,931,236,11,659,185,185,.079041913,,.17391305,85,0,,2,,.24390244,
2020-05-30,29,29,0,582,0,0,3,0,16,3,3,28,1341,1230,111,24882,0,912,959,239,11,675,188,188,.049828179,,,86,0,,1,,.2857143,
2020-05-31,4,4,0,157,0,0,1,0,13,10,10,3,1345,1234,111,25039,0,912,962,240,11,688,198,198,.025477707,,,87,0,,1,,.03508772,
2020-06-01,44,41,3,997,0,39,8,0,37,12,12,24,1389,1275,114,26036,0,951,986,248,11,725,210,210,.044132397,,.07692308,88,0,,1,,0,
2020-06-02,43,38,5,835,0,17,8,0,20,10,10,20,1432,1313,119,26871,0,968,1006,256,11,745,220,220,.051497005,,.29411766,89,0,,5,,.057142857,
2020-06-03,46,42,4,743,0,9,11,2,18,6,6,45,1478,1355,123,27614,0,977,1051,267,13,763,226,226,.061911169,,.44444445,90,0,,9,,.08219178,
2020-06-04,67,65,2,1280,0,8,16,2,26,13,13,55,1545,1420,125,28894,0,985,1106,283,15,789,239,239,.052343749,,.25,91,0,,3,,.1,
2020-06-05,44,38,6,1080,0,11,9,1,17,6,6,63,1589,1458,131,29974,0,996,1169,292,16,806,245,245,.04074074,,.54545456,92,0,,4,,.089285716,
2020-06-06,78,44,34,895,0,41,35,0,24,12,12,30,1667,1502,165,30869,0,1037,1199,327,16,830,257,257,.087150835,,.82926828,93,0,,4,,.070422538,
2020-06-07,27,14,13,212,0,13,17,1,29,20,20,6,1694,1516,178,31081,0,1050,1205,344,17,859,277,277,.1273585,,1,94,0,,2,,.25,
2020-06-08,47,46,1,1472,0,8,4,0,36,12,12,53,1741,1562,179,32553,0,1058,1258,348,17,895,289,289,.031929348,,.125,95,0,,7,,,
2020-06-09,109,103,6,1709,0,18,9,1,12,2,2,42,1850,1665,185,34262,0,1076,1300,357,18,907,291,291,.063779987,,.33333334,96,0,,5,,.18032786,
2020-06-10,50,44,6,1433,0,26,9,0,26,16,16,37,1900,1709,191,35695,0,1102,1337,366,18,933,307,307,.034891836,,.23076923,97,0,,4,,.045454547,
2020-06-11,42,40,2,1223,0,20,10,1,12,8,8,57,1942,1749,193,36918,0,1122,1394,376,19,945,315,315,.034341782,,.1,98,0,,6,,.11538462,
2020-06-12,75,47,28,1624,0,49,32,1,23,12,12,49,2017,1796,221,38542,0,1171,1443,408,20,968,327,327,.046182267,,.5714286,99,0,,5,,.18518518,
2020-06-13,37,28,9,1276,0,29,13,2,19,15,15,36,2054,1824,230,39818,0,1200,1479,421,22,987,342,342,.028996864,,.31034482,100,0,,8,,.15000001,
2020-06-14,16,16,0,120,0,0,1,0,18,9,9,13,2070,1840,230,39938,0,1200,1492,422,22,1005,351,351,.13333334,,,101,0,,6,,.28125,
2020-06-15,67,63,4,1493,0,21,10,2,37,10,10,41,2137,1903,234,41431,0,1221,1533,432,24,1042,361,361,.044876087,,.19047619,102,0,,7,,,
2020-06-16,63,57,6,1681,0,27,11,1,18,4,4,101,2200,1960,240,43112,0,1248,1634,443,25,1060,365,365,.037477691,,.22222222,103,0,,12,,.29545453,
2020-06-17,60,42,18,1676,0,35,23,4,22,5,5,55,2260,2002,258,44788,0,1283,1689,466,29,1082,370,370,.035799522,,.51428574,104,0,,9,,.11666667,
2020-06-18,44,38,6,1657,0,28,10,0,21,6,6,51,2304,2040,264,46445,0,1311,1740,476,29,1103,376,376,.026554013,,.21428572,105,0,,10,,.35714287,
2020-06-19,59,49,10,1495,0,24,13,2,17,7,7,59,2363,2089,274,47940,0,1335,1799,489,31,1120,383,383,.039464884,,.41666666,106,0,,3,,.2,
2020-06-20,65,36,29,1246,0,41,33,0,35,14,14,79,2428,2125,303,49186,0,1376,1878,522,31,1155,397,397,.052166935,,.70731705,107,0,,11,,,
2020-06-21,6,6,0,257,0,0,0,0,26,11,11,27,2434,2131,303,49443,0,1376,1905,522,31,1181,408,408,.023346303,,,108,0,,8,,.28333333,
2020-06-22,68,68,0,1555,0,15,3,0,20,12,12,73,2502,2199,303,50998,0,1391,1978,525,31,1201,420,420,.043729905,,0,109,0,,10,,,
2020-06-23,114,107,7,1877,0,17,9,0,15,7,7,73,2616,2306,310,52875,0,1408,2051,534,31,1216,427,427,.060735215,,.41176471,110,0,,13,,.24137931,
2020-06-24,64,64,0,1127,0,0,11,0,26,10,10,56,2680,2370,310,54002,0,1408,2107,545,31,1242,437,437,.056787934,,,111,0,,11,,.38372093,
2020-06-25,83,75,8,1806,0,16,13,3,23,7,7,45,2763,2445,318,55808,0,1424,2152,558,34,1265,444,444,.045957919,,.5,112,0,,8,,.31884059,
2020-06-26,103,86,17,2584,0,33,26,1,28,11,11,74,2866,2531,335,58392,0,1457,2226,584,35,1293,455,455,.039860681,,.5151515,113,0,,13,,.25510204,
2020-06-27,86,82,4,1755,0,26,16,0,23,11,11,37,2952,2613,339,60147,0,1483,2263,600,35,1316,466,466,.049002849,,.15384616,114,0,,9,,.20689656,
2020-06-28,29,28,1,337,0,1,1,3,33,14,14,7,2981,2641,340,60484,0,1484,2270,601,38,1349,480,480,.086053416,,1,115,0,,8,,.11111111,
2020-06-29,96,85,11,1695,0,19,17,0,23,12,12,58,3077,2726,351,62179,0,1503,2328,618,38,1372,492,492,.056637168,,.57894737,116,0,,13,,,
2020-06-30,93,79,14,2569,0,35,17,1,25,14,14,92,3170,2805,365,64748,0,1538,2420,635,39,1397,506,506,.036200855,,.40000001,117,0,,11,,.21428572,
2020-07-01,124,120,4,3090,0,10,16,3,91,28,28,77,3294,2925,369,67838,0,1548,2497,651,42,1488,534,534,.040129449,,.40000001,118,0,,12,,.22471911,
2020-07-02,151,135,16,3044,0,28,43,3,60,20,20,83,3445,3060,385,70882,0,1576,2580,694,45,1548,554,554,.049605783,,.5714286,119,0,,5,,.32051283,
2020-07-03,136,121,15,3482,0,36,17,2,61,30,30,78,3581,3181,400,74364,0,1612,2658,711,47,1609,584,584,.039058011,,.41666666,120,0,,,,.19607843,
2020-07-04,98,96,2,2348,0,17,10,1,55,27,27,112,3679,3277,402,76712,0,1629,2770,721,48,1664,611,611,.04173765,,.11764706,121,0,,,,.30935252,
2020-07-05,45,32,13,694,0,28,18,2,96,50,50,15,3724,3309,415,77406,0,1657,2785,739,50,1760,661,661,.064841501,,.4642857,122,0,,,,.17647059,
2020-07-06,160,145,15,2529,0,23,24,0,94,57,57,105,3884,3454,430,79935,0,1680,2890,763,50,1854,718,718,.063266113,,.65217394,123,0,,,,0,
2020-07-07,148,126,22,3264,0,45,32,1,76,43,43,92,4032,3580,452,83199,0,1725,2982,795,51,1930,761,761,.045343138,,.48888889,124,0,,,,.23134328,
2020-07-08,128,112,16,2224,0,37,27,2,61,30,30,101,4160,3692,468,85423,0,1762,3083,822,53,1991,791,791,.057553958,,.43243244,125,0,,,,.15946844,
2020-07-09,132,110,22,2553,0,37,28,3,52,30,30,130,4292,3802,490,87976,0,1799,3213,850,56,2043,821,821,.051703878,,.5945946,126,0,,,,.33689839,
2020-07-10,188,147,41,2759,0,47,55,5,156,84,84,125,4480,3949,531,90735,0,1846,3338,905,61,2199,905,905,.068140633,,.87234044,127,0,,,,.28191489,
2020-07-11,180,133,47,2221,0,61,58,5,101,58,58,80,4660,4082,578,92956,0,1907,3418,963,66,2300,963,963,.081044577,,.77049178,128,0,,,,.20091324,
2020-07-12,37,37,0,491,0,0,2,5,98,58,58,36,4697,4119,578,93447,0,1907,3454,965,71,2398,1021,1021,.075356416,,,129,0,,,,.28932583,
2020-07-13,256,198,58,3025,0,90,72,1,111,64,64,133,4953,4317,636,96472,0,1997,3587,1037,72,2509,1085,1085,.084628098,,.64444447,130,0,,,,.71428573,
2020-07-14,303,248,55,3075,0,74,76,3,118,49,49,137,5256,4565,691,99547,0,2071,3724,1113,75,2627,1134,1134,.098536588,,.74324322,131,0,,,,.28522336,
2020-07-15,276,218,58,3869,0,93,75,4,174,83,83,126,5532,4783,749,103416,0,2164,3850,1188,79,2801,1217,1217,.071336262,,.62365592,132,0,,,,.27127659,
2020-07-16,323,285,38,3212,0,48,64,6,121,67,67,126,5855,5068,787,106628,0,2212,3976,1252,85,2922,1284,1284,.1005604,,.79166669,133,0,,,,.38111889,
2020-07-17,345,285,60,3783,0,77,76,5,158,90,90,172,6200,5353,847,110411,0,2289,4148,1328,90,3080,1374,1374,.091197461,,.77922076,134,0,,,,.11872146,
2020-07-18,267,188,79,3243,0,139,101,6,184,103,103,135,6467,5541,926,113654,0,2428,4283,1429,96,3264,1477,1477,.082331173,,.56834531,135,0,,,,.3580786,
2020-07-19,55,55,0,658,0,1,8,4,179,96,96,52,6522,5596,926,114312,0,2429,4335,1437,100,3443,1573,1573,.083586626,,0,136,0,,,,.3936508,
2020-07-20,364,324,40,3740,0,55,100,7,316,148,148,211,6886,5920,966,118052,0,2484,4546,1537,107,3759,1721,1721,.097326204,,.72727275,137,0,,,,1,
2020-07-21,419,294,125,3404,0,180,157,4,199,110,110,239,7305,6214,1091,121456,0,2664,4785,1694,111,3958,1831,1831,.12309048,,.69444442,138,0,,,,1,
2020-07-22,421,306,115,3670,0,191,166,18,237,130,130,180,7726,6520,1206,125126,0,2855,4965,1860,129,4195,1961,1961,.1147139,,.60209423,139,0,,,,.39772728,
2020-07-23,373,323,50,3358,0,62,108,9,175,95,95,274,8099,6843,1256,128484,0,2917,5239,1968,138,4370,2056,2056,.11107802,,.80645162,140,0,,,,.47447446,
2020-07-24,466,384,82,4421,0,133,135,6,204,119,119,301,8565,7227,1338,132905,0,3050,5540,2103,144,4574,2175,2175,.10540602,,.61654133,141,0,,,,.42918456,
2020-07-25,523,377,146,3223,0,244,190,12,260,124,124,224,9088,7604,1484,136128,0,3294,5764,2293,156,4834,2299,2299,.16227117,,.59836066,142,0,,,,.50359714,
2020-07-26,226,119,107,1071,0,167,128,9,245,130,130,51,9314,7723,1591,137199,0,3461,5815,2421,165,5079,2429,2429,.21101774,,.64071858,143,0,,,,.55555558,
2020-07-27,532,476,56,4251,0,86,151,17,338,174,174,333,9846,8199,1647,141450,0,3547,6148,2572,182,5417,2603,2603,.12514703,,.6511628,144,0,,,,.51282054,
2020-07-28,336,317,19,2254,0,57,65,23,318,136,136,342,10182,8516,1666,143704,0,3604,6490,2637,205,5735,2739,2739,.14906833,,.33333334,145,0,,,,.64625853,
2020-07-29,686,535,151,4049,0,250,226,12,221,106,106,372,10868,9051,1817,147753,0,3854,6862,2863,217,5956,2845,2845,.16942455,,.60399997,146,0,,,,.49230769,
2020-07-30,692,530,162,4516,0,258,246,23,211,105,105,321,11560,9581,1979,152269,0,4112,7183,3109,240,6167,2950,2950,.15323295,,.62790698,147,0,,,,.42372882,
2020-07-31,721,619,102,5057,0,173,185,33,209,107,107,404,12281,10200,2081,157326,0,4285,7587,3294,273,6376,3057,3057,.14257465,,.58959538,148,0,,,,.43352601,
2020-08-01,593,534,59,3735,0,92,118,28,511,203,203,378,12874,10734,2140,161061,0,4377,7965,3412,301,6887,3260,3260,.1587684,,.64130437,149,0,,,,.36923078,
2020-08-02,188,187,1,1040,0,1,56,22,214,84,84,102,13062,10921,2141,162101,0,4378,8067,3468,323,7101,3344,3344,.18076923,,1,150,0,,,,0,
2020-08-03,905,799,106,5306,0,173,203,19,249,75,75,461,13967,11720,2247,167407,0,4551,8528,3671,342,7350,3419,3419,.17056163,,.61271673,151,0,,,,,
2020-08-04,862,805,57,5117,0,89,162,21,202,73,73,434,14829,12525,2304,172524,0,4640,8962,3833,363,7552,3492,3492,.16845807,,.64044946,152,0,,,,,
2020-08-05,839,685,154,4253,0,212,284,15,259,78,78,581,15668,13210,2458,176777,0,4852,9543,4117,378,7811,3570,3570,.19727251,,.7264151,153,0,,,,,
2020-08-06,879,715,164,4713,0,262,250,26,197,79,79,527,16547,13925,2622,181490,0,5114,10070,4367,404,8008,3649,3649,.18650541,,.62595421,154,0,,,,,
2020-08-07,918,797,121,4607,0,207,235,27,203,95,95,632,17465,14722,2743,186097,0,5321,10702,4602,431,8211,3744,3744,.19926199,,.58454108,155,0,,,,,
2020-08-08,771,602,169,3693,0,259,259,30,232,84,84,622,18236,15324,2912,189790,0,5580,11324,4861,461,8443,3828,3828,.20877336,,.65250963,156,0,,,,,
2020-08-09,173,168,5,834,0,7,31,18,184,65,65,281,18409,15492,2917,190624,0,5587,11605,4892,479,8627,3893,3893,.20743406,,.71428573,157,0,,,,,
2020-08-10,1135,1009,126,5298,0,250,238,16,404,122,122,830,19544,16501,3043,195922,0,5837,12435,5130,495,9031,4015,4015,.21423179,,.50400001,158,0,,,,,
2020-08-11,1320,1141,179,5307,0,303,330,23,169,54,54,700,20864,17642,3222,201229,0,6140,13135,5460,518,9200,4069,4069,.2487281,,.5907591,159,0,,,,,
2020-08-12,1031,918,113,4457,0,187,242,20,205,80,80,833,21895,18560,3335,205686,0,6327,13968,5702,538,9405,4149,4149,.23132151,,.60427809,160,0,,,,,
2020-08-13,1088,985,103,4453,0,211,203,29,156,55,55,874,22983,19545,3438,210139,0,6538,14842,5905,567,9561,4204,4204,.24432966,,.48815167,161,0,,,,,
2020-08-14,1087,948,139,4726,0,256,240,29,228,86,86,882,24070,20493,3577,214865,0,6794,15724,6145,596,9789,4290,4290,.23000424,,.54296875,162,0,,,,,
2020-08-15,961,816,145,3598,0,259,232,30,285,86,86,692,25031,21309,3722,218463,0,7053,16416,6377,626,10074,4376,4376,.26709282,,.55984557,163,0,,,,,
2020-08-16,157,156,1,834,0,3,20,31,143,59,59,193,25188,21465,3723,219297,0,7056,16609,6397,657,10217,4435,4435,.18824939,,.33333334,164,0,,,,,
2020-08-17,1237,1149,88,5490,0,158,207,27,202,71,71,1053,26425,22614,3811,224787,0,7214,17662,6604,684,10419,4506,4506,.22531876,,.55696201,165,0,,,,,
2020-08-18,1094,954,140,4476,0,267,286,25,205,82,82,1087,27519,23568,3951,229263,0,7481,18749,6890,709,10624,4588,4588,.24441466,,.52434456,166,0,,,,,
2020-08-19,1446,1297,149,5011,0,296,287,27,124,50,50,1018,28965,24865,4100,234274,0,7777,19767,7177,736,10748,4638,4638,.28856516,,.50337839,167,0,,,,,
2020-08-20,1685,1532,153,7020,0,256,277,29,272,113,113,1088,30650,26397,4253,241294,0,8033,20855,7454,765,11020,4751,4751,.24002849,,.59765625,168,0,,,,,
2020-08-21,1621,1593,28,6460,0,65,200,26,128,58,58,1051,32271,27990,4281,247754,0,8098,21906,7654,791,11148,4809,4809,.25092879,,.43076923,169,0,,,,,
2020-08-22,1465,1340,125,5501,0,259,271,19,118,54,54,967,33736,29330,4406,253255,0,8357,22873,7925,810,11266,4863,4863,.26631522,,.48262548,170,0,,,,,
2020-08-23,316,316,0,1402,0,0,28,15,106,31,31,138,34052,29646,4406,254657,0,8357,23011,7953,825,11372,4894,4894,.2253923,,,171,0,,,,,
2020-08-24,2988,2904,84,9161,0,205,464,15,130,42,42,1249,37040,32550,4490,263818,0,8562,24260,8417,840,11502,4936,4936,.32616526,,.40975609,172,0,,,,,
2020-08-25,1113,1042,71,4521,0,150,178,16,119,34,34,1316,38153,33592,4561,268339,0,8712,25576,8595,856,11621,4970,4970,.24618447,,.47333333,173,0,,,,,
2020-08-26,1101,996,105,4183,0,164,198,15,89,27,27,1446,39254,34588,4666,272522,0,8876,27022,8793,871,11710,4997,4997,.26320821,,.64024389,174,0,,,,,
2020-08-27,1166,1131,35,4691,0,78,133,21,82,33,33,1681,40420,35719,4701,277213,0,8954,28703,8926,892,11792,5030,5030,.24856107,,.44871795,175,0,,,,,
2020-08-28,1391,1233,158,6046,0,330,265,21,88,31,31,1742,41811,36952,4859,283259,0,9284,30445,9191,913,11880,5061,5061,.23006947,,.47878787,176,0,,,,,
2020-08-29,791,719,72,4030,0,232,135,18,65,30,30,1504,42602,37671,4931,287289,0,9516,31949,9326,931,11945,5091,5091,.19627792,,.31034482,177,0,,,,,
2020-08-30,124,124,0,718,0,0,15,18,69,30,30,318,42726,37795,4931,288007,0,9516,32267,9341,949,12014,5121,5121,.17270195,,,178,0,,,,,
2020-08-31,1059,999,60,4988,0,167,167,23,65,24,24,3009,43785,38794,4991,292995,0,9683,35276,9508,972,12079,5145,5145,.21230954,,.35928145,179,0,,,,,
2020-09-01,898,858,40,4387,0,130,128,7,168,40,40,1171,44683,39652,5031,297382,0,9813,36447,9636,979,12247,5185,5185,.20469569,,.30769232,180,0,,,,,
2020-09-02,837,783,54,4064,0,165,131,13,72,24,24,1203,45520,40435,5085,301446,0,9978,37650,9767,992,12319,5209,5209,.20595473,,.32727271,181,0,,,,,
2020-09-03,733,702,31,3626,0,121,108,5,50,15,15,1343,46253,41137,5116,305072,0,10099,38993,9875,997,12369,5224,5224,.20215113,,.25619835,182,0,,,,,
2020-09-04,749,706,43,3662,0,175,134,5,51,20,20,1323,47002,41843,5159,308734,0,10274,40316,10009,1002,12420,5244,5244,.20453304,,.24571429,183,0,,,,,
2020-09-05,487,455,32,2780,0,126,105,10,62,31,31,903,47489,42298,5191,311514,0,10400,41219,10114,1012,12482,5275,5275,.17517985,,.25396827,184,0,,,,,
2020-09-06,115,115,0,1042,0,0,9,6,33,18,18,155,47604,42413,5191,312556,0,10400,41374,10123,1018,12515,5293,5293,.11036468,,,185,0,,,,,
2020-09-07,1237,1196,41,4971,0,187,143,2,56,22,22,1179,48841,43609,5232,317527,0,10587,42553,10266,1020,12571,5315,5315,.2488433,,.21925133,186,0,,,,,
2020-09-08,1273,1250,23,5559,0,104,124,9,47,18,18,972,50114,44859,5255,323086,0,10691,43525,10390,1029,12618,5333,5333,.22899802,,.22115384,187,0,,,,,
2020-09-09,885,845,40,4712,0,178,118,7,37,10,10,915,50999,45704,5295,327798,0,10869,44440,10508,1036,12655,5343,5343,.18781833,,.22471911,188,0,,,,,
2020-09-10,705,673,32,3777,0,161,80,10,72,31,31,782,51704,46377,5327,331575,0,11030,45222,10588,1046,12727,5374,5374,.18665607,,.19875777,189,0,,,,,
2020-09-11,737,717,20,3823,0,110,77,9,35,17,17,906,52441,47094,5347,335398,0,11140,46128,10665,1055,12762,5391,5391,.19278054,,.18181819,190,0,,,,,
2020-09-12,490,473,17,2740,0,76,74,9,35,16,16,568,52931,47567,5364,338138,0,11216,46696,10739,1064,12797,5407,5407,.17883211,,.22368421,191,0,,,,,
2020-09-13,208,208,0,875,0,0,20,4,32,13,13,117,53139,47775,5364,339013,0,11216,46813,10759,1068,12829,5420,5420,.23771429,,,192,0,,,,,
2020-09-14,710,668,42,3922,0,194,94,9,32,11,11,1215,53849,48443,5406,342935,0,11410,48028,10853,1077,12861,5431,5431,.18103008,,.21649484,193,0,,,,,
2020-09-15,567,556,11,3583,0,121,60,7,52,15,15,1239,54416,48999,5417,346518,0,11531,49267,10913,1084,12913,5446,5446,.15824728,,.090909094,194,0,,,,,
2020-09-16,516,501,15,3506,0,104,53,3,24,12,12,886,54932,49500,5432,350024,0,11635,50153,10966,1087,12937,5458,5458,.14717627,,.14423077,195,0,,,,,
2020-09-17,375,360,15,2478,0,128,42,7,29,12,12,718,55307,49860,5447,352502,0,11763,50871,11008,1094,12966,5470,5470,.15133172,,.1171875,196,0,,,,,
2020-09-18,346,326,20,2515,0,174,36,5,38,14,14,804,55653,50186,5467,355017,0,11937,51675,11044,1099,13004,5484,5484,.13757455,,.11494253,197,0,,,,,
2020-09-19,284,272,12,2115,0,199,43,2,32,12,12,513,55937,50458,5479,357132,0,12136,52188,11087,1101,13036,5496,5496,.13427895,,.060301509,198,0,,,,,
2020-09-20,62,62,0,405,0,0,3,5,58,20,20,194,55999,50520,5479,357537,0,12136,52382,11090,1106,13094,5516,5516,.15308642,,,199,0,,,,,
2020-09-21,447,422,25,2845,0,217,51,4,29,13,13,838,56446,50942,5504,360382,0,12353,53220,11141,1110,13123,5529,5529,.15711775,,.11520737,200,0,,,,,
2020-09-22,368,342,26,2449,0,230,44,4,18,5,5,672,56814,51284,5530,362831,0,12583,53892,11185,1114,13141,5534,5534,.15026541,,.11304348,201,0,,,,,
2020-09-23,435,412,23,2898,0,170,40,4,20,13,13,593,57249,51696,5553,365729,0,12753,54485,11225,1118,13161,5547,5547,.15010352,,.13529412,202,0,,,,,
2020-09-24,414,391,23,2461,0,133,55,8,25,17,17,417,57663,52087,5576,368190,0,12886,54902,11280,1126,13186,5564,5564,.1682243,,.17293233,203,0,,,,,
2020-09-25,450,430,20,3165,0,137,49,6,25,10,10,367,58113,52517,5596,371355,0,13023,55269,11329,1132,13211,5574,5574,.1421801,,.14598539,204,0,,,,,
2020-09-26,294,289,5,2252,0,62,32,7,16,10,10,297,58407,52806,5601,373607,0,13085,55566,11361,1139,13227,5584,5584,.13055062,,.080645159,205,0,,,,,
2020-09-27,41,41,0,393,0,0,2,3,14,8,8,78,58448,52847,5601,374000,0,13085,55644,11363,1142,13241,5592,5592,.1043257,,,206,0,,,,,
2020-09-28,327,309,18,2783,0,76,42,6,12,4,4,471,58775,53156,5619,376783,0,13161,56115,11405,1148,13253,5596,5596,.1174991,,.23684211,207,0,,,,,
2020-09-29,533,516,17,2933,0,119,63,4,12,3,3,367,59308,53672,5636,379716,0,13280,56482,11468,1152,13265,5599,5599,.18172519,,.14285715,208,0,,,,,
2020-09-30,458,440,18,2970,0,111,29,3,20,9,9,425,59766,54112,5654,382686,0,13391,56907,11497,1155,13285,5608,5608,.15420875,,.16216215,209,0,,,,,
2020-10-01,458,447,11,2857,0,135,34,6,41,9,9,400,60224,54559,5665,385543,0,13526,57307,11531,1161,13326,5617,5617,.16030802,,.081481479,210,0,,,,,
2020-10-02,415,405,10,2513,0,98,26,4,27,6,6,436,60639,54964,5675,388056,0,13624,57743,11557,1165,13353,5623,5623,.16514127,,.10204082,211,0,,,,,
2020-10-03,406,403,3,2241,0,64,21,2,18,4,4,306,61045,55367,5678,390297,0,13688,58049,11578,1167,13371,5627,5627,.18116912,,.046875,212,0,,,,,
2020-10-04,100,100,0,507,0,0,7,1,7,1,1,47,61145,55467,5678,390804,0,13688,58096,11585,1168,13378,5628,5628,.19723865,,,213,0,,,,,
2020-10-05,296,289,7,2005,0,88,23,3,21,4,4,350,61441,55756,5685,392809,0,13776,58446,11608,1171,13399,5632,5632,.14763093,,.079545453,214,0,,,,,
2020-10-06,233,211,22,1704,0,84,30,3,12,5,5,546,61674,55967,5707,394513,0,13860,58992,11638,1174,13411,5637,5637,.13673709,,.26190478,215,0,,,,,
2020-10-07,193,187,6,1662,0,86,21,1,12,1,1,456,61867,56154,5713,396175,0,13946,59448,11659,1175,13423,5638,5638,.11612515,,.069767445,216,0,,,,,
2020-10-08,400,396,4,2813,0,97,21,4,11,3,3,462,62267,56550,5717,398988,0,14043,59910,11680,1179,13434,5641,5641,.14219694,,.041237112,217,0,,,,,
2020-10-09,497,495,2,3372,0,39,28,0,10,2,2,435,62764,57045,5719,402360,0,14082,60345,11708,1179,13444,5643,5643,.14739028,,.051282052,218,0,,,,,
2020-10-10,535,531,4,3207,0,74,49,1,24,7,7,400,63299,57576,5723,405567,0,14156,60745,11757,1180,13468,5650,5650,.16682258,,.054054055,219,0,,,,,
2020-10-11,60,60,0,597,0,1,7,1,14,4,4,97,63359,57636,5723,406164,0,14157,60842,11764,1181,13482,5654,5654,.10050251,,0,220,0,,,,,
2020-10-12,911,907,4,3521,0,64,42,1,19,3,3,310,64270,58543,5727,409685,0,14221,61152,11806,1182,13501,5657,5657,.2587333,,.0625,221,0,,,,,
2020-10-13,580,573,7,2345,0,88,51,3,14,6,6,247,64850,59116,5734,412030,0,14309,61399,11857,1185,13515,5663,5663,.24733475,,.079545453,222,0,,,,,
2020-10-14,391,385,6,2351,0,54,30,2,11,4,4,242,65241,59501,5740,414381,0,14363,61641,11887,1187,13526,5667,5667,.1663122,,.11111111,223,0,,,,,
2020-10-15,343,341,2,2136,0,73,22,0,25,11,11,427,65584,59842,5742,416517,0,14436,62068,11909,1187,13551,5678,5678,.16058053,,.02739726,224,0,,,,,
2020-10-16,326,321,5,2210,0,96,22,3,20,10,10,505,65910,60163,5747,418727,0,14532,62573,11931,1190,13571,5688,5688,.14751132,,.052083332,225,0,,,,,
2020-10-17,150,150,0,1484,0,38,11,3,12,7,7,536,66060,60313,5747,420211,0,14570,63109,11942,1193,13583,5695,5695,.10107817,,0,226,0,,,,,
2020-10-18,59,47,12,409,0,13,7,5,8,4,4,61,66119,60360,5759,420620,0,14583,63170,11949,1198,13591,5699,5699,.14425428,,.92307693,227,0,,,,,
2020-10-19,234,230,4,1717,0,46,16,7,7,4,4,790,66353,60590,5763,422337,0,14629,63960,11965,1205,13598,5703,5703,.13628422,,.086956523,228,0,,,,,
2020-10-20,328,317,11,2237,0,87,31,1,31,10,10,523,66681,60907,5774,424574,0,14716,64483,11996,1206,13629,5713,5713,.14662494,,.12643678,229,0,,,,,
2020-10-21,194,179,15,1402,0,94,33,2,12,5,5,361,66875,61086,5789,425976,0,14810,64844,12029,1208,13641,5718,5718,.13837375,,.15957446,230,0,,,,,
2020-10-22,271,258,13,1823,0,59,25,2,11,5,5,314,67146,61344,5802,427799,0,14869,65158,12054,1210,13652,5723,5723,.14865606,,.22033899,231,0,,,,,
2020-10-23,224,223,1,1788,0,41,11,2,4,1,1,324,67370,61567,5803,429587,0,14910,65482,12065,1212,13656,5724,5724,.12527964,,.024390243,232,0,,,,,
2020-10-24,188,185,3,1394,0,25,17,3,9,2,2,165,67558,61752,5806,430981,0,14935,65647,12082,1215,13665,5726,5726,.1348637,,.12,233,0,,,,,
2020-10-25,31,31,0,342,0,0,3,2,19,0,0,47,67589,61783,5806,431323,0,14935,65694,12085,1217,13684,5726,5726,.090643272,,,234,0,,,,,
2020-10-26,257,246,11,1620,0,60,25,1,22,4,4,370,67846,62029,5817,432943,0,14995,66064,12110,1218,13706,5730,5730,.15864198,,.18333334,235,0,,,,,
2020-10-27,207,206,1,1551,0,59,16,2,7,2,2,393,68053,62235,5818,434494,0,15054,66457,12126,1220,13713,5732,5732,.13346228,,.016949153,236,0,,,,,
2020-10-28,195,189,6,1458,0,74,19,5,12,2,2,209,68248,62424,5824,435952,0,15128,66666,12145,1225,13725,5734,5734,.13374485,,.081081077,237,1,,,,,
2020-10-29,191,189,2,1281,0,64,13,3,14,4,4,292,68439,62613,5826,437233,0,15192,66958,12158,1228,13739,5738,5738,.14910227,,.03125,238,0,,,,,
2020-10-30,182,182,0,1561,0,71,13,2,22,9,9,245,68621,62795,5826,438794,0,15263,67203,12171,1230,13761,5747,5747,.11659193,,0,239,0,,,,,
2020-10-31,144,142,2,1456,0,46,17,0,5,3,3,193,68765,62937,5828,440250,0,15309,67396,12188,1230,13766,5750,5750,.0989011,,.043478262,240,0,,,,,
2020-11-01,51,51,0,388,0,0,11,2,29,5,5,42,68816,62988,5828,440638,0,15309,67438,12199,1232,13795,5755,5755,.13144329,,,241,0,,,,,
2020-11-02,166,163,3,1348,0,61,13,1,13,4,4,245,68982,63151,5831,441986,0,15370,67683,12212,1233,13808,5759,5759,.1231454,,.049180329,242,0,,,,,
2020-11-03,290,278,12,2299,0,39,38,1,9,2,2,222,69272,63429,5843,444285,0,15409,67905,12250,1234,13817,5761,5761,.1261418,,.30769232,243,0,,,,,
2020-11-04,254,253,1,1996,0,34,29,2,5,1,1,201,69526,63682,5844,446281,0,15443,68106,12279,1236,13822,5762,5762,.12725452,,.029411765,244,0,,,,,
2020-11-05,221,214,7,1848,0,93,25,1,14,4,4,207,69747,63896,5851,448129,0,15536,68313,12304,1237,13836,5766,5766,.11958875,,.07526882,245,0,,,,,
2020-11-06,246,244,2,1922,0,46,14,2,15,10,10,179,69993,64140,5853,450051,0,15582,68492,12318,1239,13851,5776,5776,.12799168,,.043478262,246,0,,,,,
2020-11-07,238,236,2,1468,0,34,18,1,17,8,8,151,70231,64376,5855,451519,0,15616,68643,12336,1240,13868,5784,5784,.16212533,,.05882353,247,0,,,,,
2020-11-08,285,283,2,1605,0,36,27,2,8,3,3,49,70516,64659,5857,453124,0,15652,68692,12363,1242,13876,5787,5787,.17757009,,.055555556,248,0,,,,,
2020-11-09,152,151,1,1526,0,47,13,1,12,7,7,176,70668,64810,5858,454650,0,15699,68868,12376,1243,13888,5794,5794,.099606812,,.021276595,249,0,,,,,
2020-11-10,196,195,1,1902,0,96,15,1,21,8,8,262,70864,65005,5859,456552,0,15795,69130,12391,1244,13909,5802,5802,.10304942,,.010416667,250,0,,,,,
2020-11-11,167,165,2,1623,0,120,10,2,17,6,6,243,71031,65170,5861,458175,0,15915,69373,12401,1246,13926,5808,5808,.10289587,,.016666668,251,0,,,,,
2020-11-12,168,160,8,1499,0,154,16,4,13,6,6,211,71199,65330,5869,459674,0,16069,69584,12417,1250,13939,5814,5814,.11207472,,.051948052,252,0,,,,,
2020-11-13,183,181,2,1646,0,138,13,0,10,7,7,242,71382,65511,5871,461320,0,16207,69826,12430,1250,13949,5821,5821,.11117861,,.014492754,253,0,,,,,
2020-11-14,133,129,4,1759,0,214,17,1,13,3,3,220,71515,65640,5875,463079,0,16421,70046,12447,1251,13962,5824,5824,.075611144,,.018691588,254,0,,,,,
2020-11-15,40,40,0,381,0,2,3,1,18,7,7,258,71555,65680,5875,463460,0,16423,70304,12450,1252,13980,5831,5831,.10498688,,0,255,0,,,,,
2020-11-16,178,170,8,1600,0,232,17,1,18,5,5,158,71733,65850,5883,465060,0,16655,70462,12467,1253,13998,5836,5836,.11125,,.034482758,256,0,,,,,
2020-11-17,170,169,1,1764,0,229,6,4,11,6,6,219,71903,66019,5884,466824,0,16884,70681,12473,1257,14009,5842,5842,.096371882,,.0043668123,257,0,,,,,
2020-11-18,155,146,9,1420,0,229,19,1,8,2,2,175,72058,66165,5893,468244,0,17113,70856,12492,1258,14017,5844,5844,.10915493,,.03930131,258,0,,,,,
2020-11-19,130,118,12,1361,0,163,27,1,11,7,7,169,72188,66283,5905,469605,0,17276,71025,12519,1259,14028,5851,5851,.095518,,.073619634,259,0,,,,,
2020-11-20,157,142,15,1373,0,115,26,0,25,18,18,183,72345,66425,5920,470978,0,17391,71208,12545,1259,14053,5869,5869,.11434814,,.13043478,260,0,,,,,
2020-11-21,123,117,6,1353,0,33,8,1,9,6,6,148,72468,66542,5926,472331,0,17424,71356,12553,1260,14062,5875,5875,.090909094,,.18181819,261,0,,,,,
2020-11-22,97,97,0,545,0,0,20,0,13,6,6,68,72565,66639,5926,472876,0,17424,71424,12573,1260,14075,5881,5881,.17798164,,,262,0,,,,,
2020-11-23,156,149,7,1367,0,58,23,2,17,10,10,158,72721,66788,5933,474243,0,17482,71582,12596,1262,14092,5891,5891,.11411851,,.12068965,263,0,,,,,
2020-11-24,200,195,5,1811,0,61,16,1,9,7,7,173,72921,66983,5938,476054,0,17543,71755,12612,1263,14101,5898,5898,.11043622,,.081967212,264,0,,,,,
2020-11-25,191,182,9,1497,0,70,14,2,7,4,4,148,73112,67165,5947,477551,0,17613,71903,12626,1265,14108,5902,5902,.12758851,,.12857144,265,0,,,,,
2020-11-26,145,132,13,1623,0,61,20,2,7,2,2,131,73257,67297,5960,479174,0,17674,72034,12646,1267,14115,5904,5904,.089340724,,.21311475,266,0,,,,,
2020-11-27,274,253,21,2054,0,70,30,0,12,7,7,148,73531,67550,5981,481228,0,17744,72182,12676,1267,14127,5911,5911,.13339825,,.30000001,267,0,,,,,
2020-11-28,274,270,4,2016,0,51,11,0,13,9,9,122,73805,67820,5985,483244,0,17795,72304,12687,1267,14140,5920,5920,.1359127,,.078431375,268,0,,,,,
2020-11-29,27,27,0,311,0,2,8,2,11,7,7,90,73832,67847,5985,483555,0,17797,72394,12695,1269,14151,5927,5927,.086816721,,0,269,0,,,,,
2020-11-30,161,151,10,1490,0,62,19,0,14,9,9,164,73993,67998,5995,485045,0,17859,72558,12714,1269,14165,5936,5936,.10805369,,.16129032,270,0,,,,,
2020-12-01,136,117,19,1400,0,60,27,0,21,8,8,198,74129,68115,6014,486445,0,17919,72756,12741,1269,14186,5944,5944,.09714286,,.31666666,271,0,,,,,
2020-12-02,134,131,3,1565,0,38,12,4,4,3,3,201,74263,68246,6017,488010,0,17957,72957,12753,1273,14190,5947,5947,.085623004,,.078947365,272,0,,,,,
2020-12-03,98,88,10,1208,0,41,19,1,10,4,4,136,74361,68334,6027,489218,0,17998,73093,12772,1274,14200,5951,5951,.081125826,,.24390244,273,0,,,,,
2020-12-04,152,134,18,1396,0,63,31,3,10,3,3,259,74513,68468,6045,490614,0,18061,73352,12803,1277,14210,5954,5954,.10888252,,.2857143,274,0,,,,,
2020-12-05,117,115,2,1141,0,57,9,2,15,5,5,256,74630,68583,6047,491755,0,18118,73608,12812,1279,14225,5959,5959,.10254163,,.03508772,275,0,,,,,
2020-12-06,37,37,0,287,0,1,2,0,6,1,1,35,74667,68620,6047,492042,0,18119,73643,12814,1279,14231,5960,5960,.12891985,,0,276,0,,,,,
2020-12-07,111,107,4,1054,0,70,14,1,12,9,9,157,74778,68727,6051,493096,0,18189,73800,12828,1280,14243,5969,5969,.10531309,,.057142857,277,0,,,,,
2020-12-08,73,67,6,800,0,73,10,1,9,7,7,119,74851,68794,6057,493896,0,18262,73919,12838,1281,14252,5976,5976,.091250002,,.08219178,278,0,,,,,
2020-12-09,132,129,3,1498,0,30,11,3,9,5,5,142,74983,68923,6060,495394,0,18292,74061,12849,1284,14261,5981,5981,.088117488,,.1,279,0,,,,,
2020-12-10,110,105,5,1323,0,56,15,2,14,11,11,113,75093,69028,6065,496717,0,18348,74174,12864,1286,14275,5992,5992,.083144367,,.089285716,280,0,,,,,
2020-12-11,218,213,5,1706,0,71,18,1,14,11,11,151,75311,69241,6070,498423,0,18419,74325,12882,1287,14289,6003,6003,.1277843,,.070422538,281,0,,,,,
2020-12-12,159,147,12,1235,0,48,20,1,13,8,8,125,75470,69388,6082,499658,0,18467,74450,12902,1288,14302,6011,6011,.12874494,,.25,282,0,,,,,
2020-12-13,32,32,0,291,0,0,4,0,15,9,9,38,75502,69420,6082,499949,0,18467,74488,12906,1288,14317,6020,6020,.10996564,,,283,0,,,,,
2020-12-14,108,97,11,1127,0,61,26,3,19,14,14,120,75610,69517,6093,501076,0,18528,74608,12932,1291,14336,6034,6034,.095829636,,.18032786,284,0,,,,,
2020-12-15,217,213,4,2074,0,88,24,3,28,20,20,101,75827,69730,6097,503150,0,18616,74709,12956,1294,14364,6054,6054,.10462873,,.045454547,285,0,,,,,
2020-12-16,319,313,6,1935,0,52,18,2,18,12,12,127,76146,70043,6103,505085,0,18668,74836,12974,1296,14382,6066,6066,.16485788,,.11538462,286,0,,,,,
2020-12-17,200,180,20,1817,0,108,28,2,19,19,19,102,76346,70223,6123,506902,0,18776,74938,13002,1298,14401,6085,6085,.11007155,,.18518518,287,0,,,,,
2020-12-18,284,272,12,2230,0,80,22,0,17,12,12,239,76630,70495,6135,509132,0,18856,75177,13024,1298,14418,6097,6097,.12735426,,.15000001,288,0,,,,,
2020-12-19,316,307,9,2394,0,32,18,0,11,7,7,156,76946,70802,6144,511526,0,18888,75333,13042,1298,14429,6104,6104,.13199666,,.28125,289,0,,,,,
2020-12-20,45,45,0,333,0,0,2,0,14,9,9,29,76991,70847,6144,511859,0,18888,75362,13044,1298,14443,6113,6113,.13513513,,,290,0,,,,,
2020-12-21,129,103,26,1173,0,88,35,2,13,9,9,109,77120,70950,6170,513032,0,18976,75471,13079,1300,14456,6122,6122,.10997442,,.29545453,291,0,,,,,
2020-12-22,63,56,7,1051,0,60,10,4,22,16,16,178,77183,71006,6177,514083,0,19036,75649,13089,1304,14478,6138,6138,.059942912,,.11666667,292,0,,,,,
2020-12-23,112,82,30,994,0,84,33,3,28,26,26,291,77295,71088,6207,515077,0,19120,75940,13122,1307,14506,6164,6164,.11267605,,.35714287,293,0,,,,,
2020-12-24,67,59,8,461,0,40,13,1,29,21,21,184,77362,71147,6215,515538,0,19160,76124,13135,1308,14535,6185,6185,.14533623,,.2,294,0,,,,,
2020-12-25,26,26,0,168,0,0,0,2,23,20,20,264,77388,71173,6215,515706,0,19160,76388,13135,1310,14558,6205,6205,.15476191,,,295,0,,,,,
2020-12-26,76,59,17,773,0,60,18,0,27,17,17,306,77464,71232,6232,516479,0,19220,76694,13153,1310,14585,6222,6222,.098318242,,.28333333,296,0,,,,,
2020-12-27,32,32,0,239,0,0,3,0,15,9,9,43,77496,71264,6232,516718,0,19220,76737,13156,1310,14600,6231,6231,.13389121,,,297,0,,,,,
2020-12-28,108,94,14,886,0,58,21,4,39,27,27,114,77604,71358,6246,517604,0,19278,76851,13177,1314,14639,6258,6258,.12189616,,.24137931,298,0,,,,,
2020-12-29,130,97,33,1093,0,86,35,0,28,19,19,92,77734,71455,6279,518697,0,19364,76943,13212,1314,14667,6277,6277,.1189387,,.38372093,299,0,,,,,
2020-12-30,75,53,22,835,0,69,26,1,39,26,26,118,77809,71508,6301,519532,0,19433,77061,13238,1315,14706,6303,6303,.089820363,,.31884059,300,0,,,,,
2020-12-31,71,46,25,755,0,98,29,1,29,22,22,95,77880,71554,6326,520287,0,19531,77156,13267,1316,14735,6325,6325,.094039738,,.25510204,301,0,,,,,
2021-01-01,46,28,18,303,0,87,26,1,68,45,45,66,77926,71582,6344,520590,0,19618,77222,13293,1317,14803,6370,6370,.15181518,,.20689656,302,0,,,,,
2021-01-02,65,61,4,644,0,36,7,0,51,28,28,88,77991,71643,6348,521234,0,19654,77310,13300,1317,14854,6398,6398,.10093167,,.11111111,303,0,,,,,
2021-01-03,33,33,0,321,0,0,3,2,48,36,36,36,78024,71676,6348,521555,0,19654,77346,13303,1319,14902,6434,6434,.10280374,,,304,0,,,,,
2021-01-04,141,111,30,1225,0,140,38,1,56,39,39,113,78165,71787,6378,522780,0,19794,77459,13341,1320,14958,6473,6473,.11510204,,.21428572,305,0,,,,,
2021-01-05,109,89,20,1108,0,89,29,1,44,31,31,99,78274,71876,6398,523888,0,19883,77558,13370,1321,15002,6504,6504,.098375455,,.22471911,306,0,,,,,
2021-01-06,147,97,50,1250,0,156,60,1,55,40,40,86,78421,71973,6448,525138,0,20039,77644,13430,1322,15057,6544,6544,.1176,,.32051283,307,0,,,,,
2021-01-07,150,120,30,1481,0,153,38,5,56,36,36,52,78571,72093,6478,526619,0,20192,77696,13468,1327,15113,6580,6580,.10128292,,.19607843,308,0,,,,,
2021-01-08,188,145,43,1383,0,139,62,9,82,59,59,20,78759,72238,6521,528002,0,20331,77716,13530,1336,15195,6639,6639,.13593636,,.30935252,309,0,,,,,
2021-01-09,136,112,24,1459,0,136,33,3,66,50,50,77,78895,72350,6545,529461,0,20467,77793,13563,1339,15261,6689,6689,.093214534,,.17647059,310,0,,,,,
2021-01-10,59,59,0,422,0,1,7,4,123,86,86,30,78954,72409,6545,529883,0,20468,77823,13570,1343,15384,6775,6775,.13981043,,0,311,0,,,,,
2021-01-11,171,140,31,1405,0,134,51,4,74,58,58,120,79125,72549,6576,531288,0,20602,77943,13621,1347,15458,6833,6833,.12170818,,.23134328,312,0,,,,,
2021-01-12,164,116,48,1585,0,301,67,2,86,60,60,127,79289,72665,6624,532873,0,20903,78070,13688,1349,15544,6893,6893,.10347003,,.15946844,313,0,,,,,
2021-01-13,165,102,63,1235,0,187,78,7,67,45,45,117,79454,72767,6687,534108,0,21090,78187,13766,1356,15611,6938,6938,.13360325,,.33689839,314,0,,,,,
2021-01-14,201,148,53,1475,0,188,71,5,70,49,49,132,79655,72915,6740,535583,0,21278,78319,13837,1361,15681,6987,6987,.13627119,,.28191489,315,0,,,,,
2021-01-15,402,358,44,2510,0,219,72,4,116,78,78,146,80057,73273,6784,538093,0,21497,78465,13909,1365,15797,7065,7065,.16015936,,.20091324,316,0,,,,,
2021-01-16,302,199,103,2004,0,356,120,6,85,65,65,108,80359,73472,6887,540097,0,21853,78573,14029,1371,15882,7130,7130,.1506986,,.28932583,317,0,,,,,
2021-01-17,69,64,5,456,0,7,25,5,95,69,69,57,80428,73536,6892,540553,0,21860,78630,14054,1376,15977,7199,7199,.15131579,,.71428573,318,0,,,,,
2021-01-18,272,189,83,1458,0,291,104,8,132,87,87,161,80700,73725,6975,542011,0,22151,78791,14158,1384,16109,7286,7286,.18655692,,.28522336,319,0,,,,,
2021-01-19,205,154,51,1349,0,188,68,6,94,75,75,140,80905,73879,7026,543360,0,22339,78931,14226,1390,16203,7361,7361,.15196441,,.27127659,320,0,,,,,
2021-01-20,326,217,109,1739,0,286,141,7,155,111,111,152,81231,74096,7135,545099,0,22625,79083,14367,1397,16358,7472,7472,.18746406,,.38111889,321,0,,,,,
2021-01-21,274,222,52,1879,0,438,91,12,92,75,75,180,81505,74318,7187,546978,0,23063,79263,14458,1409,16450,7547,7547,.14582224,,.11872146,322,0,,,,,
2021-01-22,288,206,82,1854,0,229,130,9,94,75,75,393,81793,74524,7269,548832,0,23292,79656,14588,1418,16544,7622,7622,.15533981,,.3580786,323,0,,,,,
2021-01-23,268,144,124,1284,0,315,150,10,96,77,77,224,82061,74668,7393,550116,0,23607,79880,14738,1428,16640,7699,7699,.20872274,,.3936508,324,0,,,,,
2021-01-24,90,87,3,615,0,3,26,3,91,77,77,69,82151,74755,7396,550731,0,23610,79949,14764,1431,16731,7776,7776,.14634146,,1,325,0,,,,,
2021-01-25,228,223,5,1751,0,5,49,11,103,80,80,231,82379,74978,7401,552482,0,23615,80180,14813,1442,16834,7856,7856,.13021131,,1,326,0,,,,,
2021-01-26,241,171,70,1886,0,176,109,8,98,86,86,196,82620,75149,7471,554368,0,23791,80376,14922,1450,16932,7942,7942,.12778367,,.39772728,327,0,,,,,
2021-01-27,370,212,158,2111,0,333,202,10,64,58,58,274,82990,75361,7629,556479,0,24124,80650,15124,1460,16996,8000,8000,.17527238,,.47447446,328,0,,,,,
2021-01-28,272,172,100,1996,0,233,167,13,62,50,50,268,83262,75533,7729,558475,0,24357,80918,15291,1473,17058,8050,8050,.13627255,,.42918456,329,0,,,,,
2021-01-29,325,185,140,2390,0,278,190,11,33,30,30,260,83587,75718,7869,560865,0,24635,81178,15481,1484,17091,8080,8080,.13598326,,.50359714,330,0,,,,,
2021-01-30,212,162,50,2578,0,90,105,8,40,36,36,257,83799,75880,7919,563443,0,24725,81435,15586,1492,17131,8116,8116,.082234293,,.55555558,331,0,,,,,
2021-01-31,164,64,100,924,0,195,120,13,25,22,22,93,83963,75944,8019,564367,0,24920,81528,15706,1505,17156,8138,8138,.17748918,,.51282054,332,0,,,,,
2021-02-01,281,186,95,2939,0,147,157,9,24,22,22,321,84244,76130,8114,567306,0,25067,81849,15863,1514,17180,8160,8160,.095610753,,.64625853,333,0,,,,,
2021-02-02,229,165,64,2365,0,130,122,8,9,6,6,256,84473,76295,8178,569671,0,25197,82105,15985,1522,17189,8166,8166,.096828751,,.49230769,334,0,,,,,
2021-02-03,190,140,50,2222,0,118,89,13,6,6,6,337,84663,76435,8228,571893,0,25315,82442,16074,1535,17195,8172,8172,.085508548,,.42372882,335,0,,,,,
2021-02-04,209,134,75,2480,0,173,136,11,4,3,3,281,84872,76569,8303,574373,0,25488,82723,16210,1546,17199,8175,8175,.084274195,,.43352601,336,0,,,,,
2021-02-05,192,96,96,1896,0,260,131,12,1,0,0,311,85064,76665,8399,576269,0,25748,83034,16341,1558,17200,8175,8175,.10126583,,.36923078,337,0,,,,,
2021-02-06,10,10,0,246,0,1,4,5,,,,316,85074,76675,8399,576515,0,25749,83350,16345,1563,17200,8175,8175,.040650405,,0,338,0,,,,,
2021-02-07,,,,,,,,,,,,69,85074,76675,8399,576515,0,25749,83419,16345,1563,17200,8175,8175,,,,339,,,,,,
2021-02-08,,,,,,,,,,,,263,85074,76675,8399,576515,0,25749,83682,16345,1563,17200,8175,8175,,,,340,,,,,,
2021-02-09,,,,,,,,,,,,289,85074,76675,8399,576515,0,25749,83971,16345,1563,17200,8175,8175,,,,341,,,,,,
2021-02-10,,,,,,,,,,,,417,85074,76675,8399,576515,0,25749,84388,16345,1563,17200,8175,8175,,,,342,,,,,,
2021-02-11,,,,,,,,,,,,328,85074,76675,8399,576515,0,25749,84716,16345,1563,17200,8175,8175,,,,343,,,,,,
2021-02-12,,,,,,,,,,,,340,85074,76675,8399,576515,0,25749,85056,16345,1563,17200,8175,8175,,,,344,,,,,,
2021-02-13,,,,,,,,,,,,204,85074,76675,8399,576515,0,25749,85260,16345,1563,17200,8175,8175,,,,345,,,,,,
2021-02-14,,,,,,,,,,,,159,85074,76675,8399,576515,0,25749,85419,16345,1563,17200,8175,8175,,,,346,,,,,,
2021-02-15,,,,,,,,,,,,273,85074,76675,8399,576515,0,25749,85692,16345,1563,17200,8175,8175,,,,347,,,,,,
2021-02-16,,,,,,,,,,,,207,85074,76675,8399,576515,0,25749,85899,16345,1563,17200,8175,8175,,,,348,,,,,,
2021-02-17,,,,,,,,,,,,180,85074,76675,8399,576515,0,25749,86079,16345,1563,17200,8175,8175,,,,349,,,,,,
2021-02-18,,,,,,,,,,,,212,85074,76675,8399,576515,0,25749,86291,16345,1563,17200,8175,8175,,,,350,,,,,,
2021-02-19,,,,,,,,,,,,200,85074,76675,8399,576515,0,25749,86491,16345,1563,17200,8175,8175,,,,351,,,,,,
2021-02-20,,,,,,,,,,,,29,85074,76675,8399,576515,0,25749,86520,16345,1563,17200,8175,8175,,,,352,,,,,,
2021-02-28,,,,,,,,,0,0,0,,85074,76675,8399,576515,0,25749,86520,16345,1563,17200,8175,8175,,,,353,,,,,,
2021-12-04,,,,,,,,,0,0,0,,85074,76675,8399,576515,0,25749,86520,16345,1563,17200,8175,8175,,,,354,,,,,,
,,,,,,,,,0,0,0,0,85074,76675,8399,576515,0,25749,86520,16345,1563,17200,8175,8175,,,,355,,,,,,
