fecha,positivo,positivo_rapida,positivo_molecular,muestra,muestra_rapida,muestra_molecular,sintomaticos,defunciones,inicio,inicio_molecular,inicio_rapida,recuperado,total_positivo,total_positivo_rapida,total_positivo_molecular,total_muestra,total_muestra_rapida,total_muestra_molecular,total_recuperado,total_sintomaticos,total_defunciones,total_inicio,total_inicio_molecular,total_inicio_rapida,posi,posi_rapida,posi_molecular
2020-03-06,,,,,,,,,1,1,1,,0,0,0,0,0,0,0,0,0,1,1,1,,,
2020-03-07,,,,,,,,,2,1,1,,0,0,0,0,0,0,0,0,0,3,2,2,,,
2020-03-08,,,,,,,,,1,1,1,,0,0,0,0,0,0,0,0,0,4,3,3,,,
2020-03-09,,,,,,,,,1,1,1,,0,0,0,0,0,0,0,0,0,5,4,4,,,
2020-03-10,,,,,,,,,2,2,2,,0,0,0,0,0,0,0,0,0,7,6,6,,,
2020-03-11,,,,,,,,,0,0,0,,0,0,0,0,0,0,0,0,0,7,6,6,,,
2020-03-12,,,,,,,,,0,0,0,,0,0,0,0,0,0,0,0,0,7,6,6,,,
2020-03-13,1,0,1,3,0,3,1,0,0,0,0,,1,0,1,3,0,3,0,1,0,7,6,6,.33333334,,.33333334
2020-03-14,0,0,0,1,0,0,0,0,2,1,1,,1,0,1,4,0,3,0,1,0,9,7,7,0,,
2020-03-15,0,0,0,21,0,18,0,0,4,3,3,,1,0,1,25,0,21,0,1,0,13,10,10,0,,0
2020-03-16,0,0,0,2,0,2,0,0,3,2,2,,1,0,1,27,0,23,0,1,0,16,12,12,0,,0
2020-03-17,0,0,0,1,0,1,0,0,4,2,2,,1,0,1,28,0,24,0,1,0,20,14,14,0,,0
2020-03-18,3,0,3,16,0,16,3,0,5,4,4,,4,0,4,44,0,40,0,4,0,25,18,18,.1875,,.1875
2020-03-19,0,0,0,3,0,1,0,0,2,2,2,,4,0,4,47,0,41,0,4,0,27,20,20,0,,0
2020-03-20,1,1,0,16,0,14,0,0,7,5,5,,5,1,4,63,0,55,0,4,0,34,25,25,.0625,,0
2020-03-21,0,0,0,12,0,12,0,0,4,3,3,,5,1,4,75,0,67,0,4,0,38,28,28,0,,0
2020-03-22,3,1,2,5,0,4,2,0,4,3,3,,8,2,6,80,0,71,0,6,0,42,31,31,.60000002,,.5
2020-03-23,0,0,0,20,0,20,0,0,3,2,2,,8,2,6,100,0,91,0,6,0,45,33,33,0,,0
2020-03-24,4,0,4,14,0,13,4,1,8,7,7,,12,2,10,114,0,104,0,10,1,53,40,40,.2857143,,.30769232
2020-03-25,1,1,0,2,0,0,0,0,6,6,6,,13,3,10,116,0,104,0,10,1,59,46,46,.5,,
2020-03-26,0,0,0,1,0,1,0,0,5,4,4,,13,3,10,117,0,105,0,10,1,64,50,50,0,,0
2020-03-27,2,0,2,20,0,19,2,1,5,4,4,2,15,3,12,137,0,124,2,12,2,69,54,54,.1,,.10526316
2020-03-28,16,0,16,33,0,32,16,0,2,1,1,,31,3,28,170,0,156,2,28,2,71,55,55,.4848485,,.5
2020-03-29,0,0,0,1,0,0,0,0,4,2,2,,31,3,28,171,0,156,2,28,2,75,57,57,0,,
2020-03-30,6,0,6,27,0,24,6,0,4,2,2,,37,3,34,198,0,180,2,34,2,79,59,59,.22222222,,.25
2020-03-31,4,0,4,27,0,27,4,0,3,3,3,,41,3,38,225,0,207,2,38,2,82,62,62,.14814815,,.14814815
2020-04-01,1,1,0,3,0,0,0,0,10,0,0,4,42,4,38,228,0,207,6,38,2,92,62,62,.33333334,,
2020-04-02,7,1,6,19,0,15,6,1,4,1,1,,49,5,44,247,0,222,6,44,3,96,63,63,.36842105,,.40000001
2020-04-03,4,0,4,18,0,17,4,0,4,1,1,,53,5,48,265,0,239,6,48,3,100,64,64,.22222222,,.23529412
2020-04-04,12,8,4,654,0,8,5,0,7,3,3,,65,13,52,919,0,247,6,53,3,107,67,67,.018348623,,.5
2020-04-05,2,0,2,37,0,17,2,0,7,2,2,3,67,13,54,956,0,264,9,55,3,114,69,69,.054054055,,.11764706
2020-04-06,1,1,0,18,0,7,0,0,4,1,1,,68,14,54,974,0,271,9,55,3,118,70,70,.055555556,,0
2020-04-07,1,1,0,182,0,4,0,0,4,3,3,4,69,15,54,1156,0,275,13,55,3,122,73,73,.0054945056,,0
2020-04-08,5,3,2,20,0,11,4,0,2,0,0,1,74,18,56,1176,0,286,14,59,3,124,73,73,.25,,.18181819
2020-04-09,2,0,2,49,0,10,2,0,2,2,2,,76,18,58,1225,0,296,14,61,3,126,75,75,.040816326,,.2
2020-04-10,3,3,0,17,0,0,0,0,8,2,2,2,79,21,58,1242,0,296,16,61,3,134,77,77,.17647059,,
2020-04-11,39,38,1,85,0,8,3,0,3,0,0,22,118,59,59,1327,0,304,38,64,3,137,77,77,.45882353,,.125
2020-04-12,0,0,0,7,0,0,0,0,2,1,1,,118,59,59,1334,0,304,38,64,3,139,78,78,0,,
2020-04-13,1,0,1,47,0,7,0,0,2,0,0,6,119,59,60,1381,0,311,44,64,3,141,78,78,.021276595,,.14285715
2020-04-14,5,3,2,31,0,8,1,0,2,0,0,5,124,62,62,1412,0,319,49,65,3,143,78,78,.16129032,,.25
2020-04-15,1,1,0,157,0,0,0,0,11,1,1,3,125,63,62,1569,0,319,52,65,3,154,79,79,.0063694268,,
2020-04-16,8,6,2,525,0,6,2,0,4,0,0,7,133,69,64,2094,0,325,59,67,3,158,79,79,.015238095,,.33333334
2020-04-17,11,10,1,393,0,8,1,0,10,0,0,6,144,79,65,2487,0,333,65,68,3,168,79,79,.027989822,,.125
2020-04-18,14,14,0,622,0,28,2,0,7,1,1,38,158,93,65,3109,0,361,103,70,3,175,80,80,.022508038,,0
2020-04-19,0,0,0,326,0,0,0,0,8,1,1,2,158,93,65,3435,0,361,105,70,3,183,81,81,0,,
2020-04-20,18,18,0,742,0,2,4,0,20,1,1,1,176,111,65,4177,0,363,106,74,3,203,82,82,.024258761,,0
2020-04-21,6,6,0,502,0,11,3,0,13,0,0,3,182,117,65,4679,0,374,109,77,3,216,82,82,.011952192,,0
2020-04-22,23,22,1,516,0,5,5,1,10,1,1,3,205,139,66,5195,0,379,112,82,4,226,83,83,.044573642,,.2
2020-04-23,23,21,2,347,0,3,2,0,12,1,1,6,228,160,68,5542,0,382,118,84,4,238,84,84,.066282421,,.66666669
2020-04-24,9,8,1,366,0,36,2,0,11,0,0,10,237,168,69,5908,0,418,128,86,4,249,84,84,.024590164,,.027777778
2020-04-25,13,13,0,239,0,8,1,0,8,0,0,18,250,181,69,6147,0,426,146,87,4,257,84,84,.054393306,,0
2020-04-26,0,0,0,18,0,7,0,0,2,1,1,,250,181,69,6165,0,433,146,87,4,259,85,85,0,,0
2020-04-27,14,14,0,240,0,13,2,0,9,2,2,16,264,195,69,6405,0,446,162,89,4,268,87,87,.058333334,,0
2020-04-28,21,21,0,203,0,12,3,0,11,2,2,7,285,216,69,6608,0,458,169,92,4,279,89,89,.10344828,,0
2020-04-29,23,21,2,425,0,29,9,0,10,0,0,11,308,237,71,7033,0,487,180,101,4,289,89,89,.054117646,,.068965517
2020-04-30,39,39,0,423,0,12,10,0,12,0,0,14,347,276,71,7456,0,499,194,111,4,301,89,89,.092198581,,0
2020-05-01,5,5,0,95,0,29,1,0,29,1,1,4,352,281,71,7551,0,528,198,112,4,330,90,90,.052631579,,0
2020-05-02,16,16,0,170,0,4,4,0,12,2,2,13,368,297,71,7721,0,532,211,116,4,342,92,92,.094117649,,0
2020-05-03,3,3,0,44,0,0,1,0,6,2,2,,371,300,71,7765,0,532,211,117,4,348,94,94,.06818182,,
2020-05-04,11,10,1,440,0,21,4,0,9,2,2,16,382,310,72,8205,0,553,227,121,4,357,96,96,.025,,.047619049
2020-05-05,29,29,0,663,0,22,4,0,20,3,3,22,411,339,72,8868,0,575,249,125,4,377,99,99,.043740574,,0
2020-05-06,55,51,4,1017,0,11,7,0,16,3,3,25,466,390,76,9885,0,586,274,132,4,393,102,102,.054080628,,.36363637
2020-05-07,47,44,3,552,0,11,7,1,9,2,2,49,513,434,79,10437,0,597,323,139,5,402,104,104,.08514493,,.27272728
2020-05-08,48,47,1,680,0,16,8,0,4,0,0,9,561,481,80,11117,0,613,332,147,5,406,104,104,.070588239,,.0625
2020-05-09,14,14,0,326,0,14,1,0,7,1,1,16,575,495,80,11443,0,627,348,148,5,413,105,105,.042944785,,0
2020-05-10,2,2,0,98,0,0,1,1,16,0,0,3,577,497,80,11541,0,627,351,149,6,429,105,105,.020408163,,
2020-05-11,63,63,0,852,0,15,5,0,10,1,1,9,640,560,80,12393,0,642,360,154,6,439,106,106,.07394366,,0
2020-05-12,44,43,1,735,0,30,2,0,16,7,7,15,684,603,81,13128,0,672,375,156,6,455,113,113,.059863947,,.033333335
2020-05-13,76,74,2,1175,0,10,8,1,8,5,5,40,760,677,83,14303,0,682,415,164,7,463,118,118,.064680852,,.2
2020-05-14,39,39,0,426,0,23,5,0,6,2,2,23,799,716,83,14729,0,705,438,169,7,469,120,120,.091549292,,0
2020-05-15,10,9,1,450,0,15,4,2,17,5,5,22,809,725,84,15179,0,720,460,173,9,486,125,125,.022222223,,.06666667
2020-05-16,16,16,0,399,0,29,1,0,12,5,5,7,825,741,84,15578,0,749,467,174,9,498,130,130,.04010025,,0
2020-05-17,1,1,0,62,0,0,0,0,10,3,3,1,826,742,84,15640,0,749,468,174,9,508,133,133,.016129032,,
2020-05-18,19,18,1,349,0,14,2,0,16,6,6,50,845,760,85,15989,0,763,518,176,9,524,139,139,.054441262,,.071428575
2020-05-19,53,53,0,944,0,18,3,1,6,3,3,34,898,813,85,16933,0,781,552,179,10,530,142,142,.056144066,,0
2020-05-20,37,36,1,711,0,15,3,0,17,4,4,69,935,849,86,17644,0,796,621,182,10,547,146,146,.052039381,,.06666667
2020-05-21,49,44,5,950,0,16,12,0,3,1,1,49,984,893,91,18594,0,812,670,194,10,550,147,147,.051578946,,.3125
2020-05-22,47,44,3,883,0,11,5,0,13,6,6,34,1031,937,94,19477,0,823,704,199,10,563,153,153,.053227633,,.27272728
2020-05-23,34,33,1,505,0,15,4,0,4,0,0,16,1065,970,95,19982,0,838,720,203,10,567,153,153,.067326732,,.06666667
2020-05-24,5,5,0,106,0,0,1,1,12,3,3,2,1070,975,95,20088,0,838,722,204,11,579,156,156,.047169812,,
2020-05-25,45,38,7,692,0,24,12,0,26,7,7,25,1115,1013,102,20780,0,862,747,216,11,605,163,163,.065028898,,.29166666
2020-05-26,32,29,3,739,0,18,4,0,11,5,5,67,1147,1042,105,21519,0,880,814,220,11,616,168,168,.043301757,,.16666667
2020-05-27,46,44,2,1009,0,11,5,0,9,2,2,48,1193,1086,107,22528,0,891,862,225,11,625,170,170,.045589693,,.18181819
2020-05-28,53,53,0,943,0,1,5,0,15,3,3,42,1246,1139,107,23471,0,892,904,230,11,640,173,173,.056203604,,0
2020-05-29,66,62,4,835,0,23,6,0,16,12,12,27,1312,1201,111,24306,0,915,931,236,11,656,185,185,.079041913,,.17391305
2020-05-30,29,29,0,582,0,0,3,0,16,3,3,28,1341,1230,111,24888,0,915,959,239,11,672,188,188,.049828179,,
2020-05-31,4,4,0,158,0,0,1,0,13,10,10,3,1345,1234,111,25046,0,915,962,240,11,685,198,198,.025316456,,
2020-06-01,44,41,3,997,0,39,8,0,37,12,12,24,1389,1275,114,26043,0,954,986,248,11,722,210,210,.044132397,,.07692308
2020-06-02,43,38,5,835,0,17,8,0,20,10,10,20,1432,1313,119,26878,0,971,1006,256,11,742,220,220,.051497005,,.29411766
2020-06-03,46,42,4,743,0,9,11,2,18,6,6,45,1478,1355,123,27621,0,980,1051,267,13,760,226,226,.061911169,,.44444445
2020-06-04,67,65,2,1280,0,8,16,2,26,13,13,55,1545,1420,125,28901,0,988,1106,283,15,786,239,239,.052343749,,.25
2020-06-05,44,38,6,1080,0,11,9,1,17,6,6,63,1589,1458,131,29981,0,999,1169,292,16,803,245,245,.04074074,,.54545456
2020-06-06,78,44,34,895,0,41,35,0,24,12,12,30,1667,1502,165,30876,0,1040,1199,327,16,827,257,257,.087150835,,.82926828
2020-06-07,27,14,13,212,0,13,17,1,29,20,20,6,1694,1516,178,31088,0,1053,1205,344,17,856,277,277,.1273585,,1
2020-06-08,47,46,1,1472,0,8,4,0,36,12,12,53,1741,1562,179,32560,0,1061,1258,348,17,892,289,289,.031929348,,.125
2020-06-09,109,103,6,1709,0,18,9,1,12,2,2,42,1850,1665,185,34269,0,1079,1300,357,18,904,291,291,.063779987,,.33333334
2020-06-10,50,44,6,1433,0,26,9,0,26,16,16,37,1900,1709,191,35702,0,1105,1337,366,18,930,307,307,.034891836,,.23076923
2020-06-11,42,40,2,1223,0,20,10,1,12,8,8,57,1942,1749,193,36925,0,1125,1394,376,19,942,315,315,.034341782,,.1
2020-06-12,75,47,28,1624,0,49,32,1,23,12,12,49,2017,1796,221,38549,0,1174,1443,408,20,965,327,327,.046182267,,.5714286
2020-06-13,37,28,9,1276,0,29,13,2,19,15,15,36,2054,1824,230,39825,0,1203,1479,421,22,984,342,342,.028996864,,.31034482
2020-06-14,16,16,0,120,0,0,1,0,18,9,9,13,2070,1840,230,39945,0,1203,1492,422,22,1002,351,351,.13333334,,
2020-06-15,67,63,4,1493,0,21,10,2,37,10,10,41,2137,1903,234,41438,0,1224,1533,432,24,1039,361,361,.044876087,,.19047619
2020-06-16,63,57,6,1682,0,27,11,1,18,4,4,101,2200,1960,240,43120,0,1251,1634,443,25,1057,365,365,.03745541,,.22222222
2020-06-17,60,42,18,1676,0,35,23,4,22,5,5,55,2260,2002,258,44796,0,1286,1689,466,29,1079,370,370,.035799522,,.51428574
2020-06-18,44,38,6,1655,0,28,10,0,21,6,6,51,2304,2040,264,46451,0,1314,1740,476,29,1100,376,376,.026586102,,.21428572
2020-06-19,59,49,10,1495,0,24,13,2,17,7,7,59,2363,2089,274,47946,0,1338,1799,489,31,1117,383,383,.039464884,,.41666666
2020-06-20,65,36,29,1247,0,42,33,0,35,14,14,79,2428,2125,303,49193,0,1380,1878,522,31,1152,397,397,.0521251,,.69047618
2020-06-21,6,6,0,257,0,0,0,0,26,11,11,27,2434,2131,303,49450,0,1380,1905,522,31,1178,408,408,.023346303,,
2020-06-22,68,68,0,1555,0,15,3,0,20,12,12,73,2502,2199,303,51005,0,1395,1978,525,31,1198,420,420,.043729905,,0
2020-06-23,114,107,7,1877,0,17,9,0,15,7,7,73,2616,2306,310,52882,0,1412,2051,534,31,1213,427,427,.060735215,,.41176471
2020-06-24,64,64,0,1128,0,0,11,0,26,10,10,56,2680,2370,310,54010,0,1412,2107,545,31,1239,437,437,.056737587,,
2020-06-25,83,75,8,1806,0,16,13,3,23,7,7,45,2763,2445,318,55816,0,1428,2152,558,34,1262,444,444,.045957919,,.5
2020-06-26,103,86,17,2584,0,33,26,1,28,11,11,74,2866,2531,335,58400,0,1461,2226,584,35,1290,455,455,.039860681,,.5151515
2020-06-27,86,82,4,1755,0,26,16,0,23,11,11,37,2952,2613,339,60155,0,1487,2263,600,35,1313,466,466,.049002849,,.15384616
2020-06-28,29,28,1,337,0,1,1,3,33,14,14,7,2981,2641,340,60492,0,1488,2270,601,38,1346,480,480,.086053416,,1
2020-06-29,96,85,11,1695,0,19,17,0,23,12,12,58,3077,2726,351,62187,0,1507,2328,618,38,1369,492,492,.056637168,,.57894737
2020-06-30,93,79,14,2569,0,35,17,1,25,14,14,92,3170,2805,365,64756,0,1542,2420,635,39,1394,506,506,.036200855,,.40000001
2020-07-01,124,120,4,3090,0,10,16,3,91,28,28,77,3294,2925,369,67846,0,1552,2497,651,42,1485,534,534,.040129449,,.40000001
2020-07-02,151,135,16,3044,0,28,43,3,60,20,20,83,3445,3060,385,70890,0,1580,2580,694,45,1545,554,554,.049605783,,.5714286
2020-07-03,135,120,15,3479,0,36,17,2,61,30,30,78,3580,3180,400,74369,0,1616,2658,711,47,1606,584,584,.038804255,,.41666666
2020-07-04,98,96,2,2347,0,17,10,1,55,27,27,112,3678,3276,402,76716,0,1633,2770,721,48,1661,611,611,.041755434,,.11764706
2020-07-05,45,32,13,694,0,28,18,2,96,50,50,15,3723,3308,415,77410,0,1661,2785,739,50,1757,661,661,.064841501,,.4642857
2020-07-06,160,145,15,2528,0,23,24,0,94,57,57,105,3883,3453,430,79938,0,1684,2890,763,50,1851,718,718,.06329114,,.65217394
2020-07-07,148,126,22,3264,0,45,32,1,76,43,43,92,4031,3579,452,83202,0,1729,2982,795,51,1927,761,761,.045343138,,.48888889
2020-07-08,128,112,16,2224,0,37,27,2,61,30,30,101,4159,3691,468,85426,0,1766,3083,822,53,1988,791,791,.057553958,,.43243244
2020-07-09,132,110,22,2553,0,37,28,3,51,29,29,130,4291,3801,490,87979,0,1803,3213,850,56,2039,820,820,.051703878,,.5945946
2020-07-10,188,147,41,2759,0,47,55,5,156,84,84,124,4479,3948,531,90738,0,1850,3337,905,61,2195,904,904,.068140633,,.87234044
2020-07-11,180,133,47,2219,0,61,58,5,101,58,58,80,4659,4081,578,92957,0,1911,3417,963,66,2296,962,962,.081117623,,.77049178
2020-07-12,37,37,0,491,0,0,2,5,98,58,58,36,4696,4118,578,93448,0,1911,3453,965,71,2394,1020,1020,.075356416,,
2020-07-13,256,198,58,3025,0,90,72,1,111,64,64,133,4952,4316,636,96473,0,2001,3586,1037,72,2505,1084,1084,.084628098,,.64444447
2020-07-14,303,248,55,3075,0,74,76,3,118,49,49,137,5255,4564,691,99548,0,2075,3723,1113,75,2623,1133,1133,.098536588,,.74324322
2020-07-15,277,218,59,3872,0,96,76,4,175,84,84,126,5532,4782,750,103420,0,2171,3849,1189,79,2798,1217,1217,.071539253,,.61458331
2020-07-16,323,285,38,3213,0,48,64,6,121,67,67,126,5855,5067,788,106633,0,2219,3975,1253,85,2919,1284,1284,.1005291,,.79166669
2020-07-17,345,285,60,3782,0,77,76,5,158,90,90,172,6200,5352,848,110415,0,2296,4147,1329,90,3077,1374,1374,.091221578,,.77922076
2020-07-18,267,188,79,3241,0,140,101,6,184,103,103,135,6467,5540,927,113656,0,2436,4282,1430,96,3261,1477,1477,.082381979,,.5642857
2020-07-19,55,55,0,658,0,1,8,4,178,95,95,52,6522,5595,927,114314,0,2437,4334,1438,100,3439,1572,1572,.083586626,,0
2020-07-20,364,324,40,3741,0,56,100,7,317,148,148,211,6886,5919,967,118055,0,2493,4545,1538,107,3756,1720,1720,.097300187,,.71428573
2020-07-21,419,294,125,3407,0,180,157,4,199,110,110,239,7305,6213,1092,121462,0,2673,4784,1695,111,3955,1830,1830,.12298209,,.69444442
2020-07-22,421,306,115,3669,0,194,166,18,239,131,131,180,7726,6519,1207,125131,0,2867,4964,1861,129,4194,1961,1961,.11474516,,.59278351
2020-07-23,373,323,50,3358,0,62,108,9,174,94,94,274,8099,6842,1257,128489,0,2929,5238,1969,138,4368,2055,2055,.11107802,,.80645162
2020-07-24,466,384,82,4421,0,133,135,6,203,119,119,301,8565,7226,1339,132910,0,3062,5539,2104,144,4571,2174,2174,.10540602,,.61654133
2020-07-25,523,377,146,3223,0,245,190,12,260,124,124,224,9088,7603,1485,136133,0,3307,5763,2294,156,4831,2298,2298,.16227117,,.59591836
2020-07-26,226,119,107,1073,0,168,128,9,246,131,131,51,9314,7722,1592,137206,0,3475,5814,2422,165,5077,2429,2429,.21062441,,.63690478
2020-07-27,532,476,56,4250,0,86,151,17,340,176,176,333,9846,8198,1648,141456,0,3561,6147,2573,182,5417,2605,2605,.12517647,,.6511628
2020-07-28,336,317,19,2252,0,57,65,23,318,136,136,342,10182,8515,1667,143708,0,3618,6489,2638,205,5735,2741,2741,.14920071,,.33333334
2020-07-29,686,535,151,4048,0,250,226,12,221,106,106,373,10868,9050,1818,147756,0,3868,6862,2864,217,5956,2847,2847,.16946641,,.60399997
2020-07-30,692,530,162,4516,0,258,246,23,211,105,105,321,11560,9580,1980,152272,0,4126,7183,3110,240,6167,2952,2952,.15323295,,.62790698
2020-07-31,721,619,102,5059,0,174,185,33,209,107,107,404,12281,10199,2082,157331,0,4300,7587,3295,273,6376,3059,3059,.14251828,,.58620691
2020-08-01,593,534,59,3735,0,92,118,28,510,202,202,378,12874,10733,2141,161066,0,4392,7965,3413,301,6886,3261,3261,.1587684,,.64130437
2020-08-02,188,187,1,1040,0,1,56,22,214,84,84,102,13062,10920,2142,162106,0,4393,8067,3469,323,7100,3345,3345,.18076923,,1
2020-08-03,906,799,107,5307,0,174,204,19,248,74,74,461,13968,11719,2249,167413,0,4567,8528,3673,342,7348,3419,3419,.17071792,,.61494255
2020-08-04,862,805,57,5118,0,90,162,21,202,73,73,434,14830,12524,2306,172531,0,4657,8962,3835,363,7550,3492,3492,.16842517,,.63333333
2020-08-05,839,685,154,4254,0,213,284,15,259,78,78,581,15669,13209,2460,176785,0,4870,9543,4119,378,7809,3570,3570,.19722614,,.7230047
2020-08-06,879,715,164,4713,0,263,250,26,197,79,79,527,16548,13924,2624,181498,0,5133,10070,4369,404,8006,3649,3649,.18650541,,.62357414
2020-08-07,918,797,121,4607,0,207,235,27,202,94,94,632,17466,14721,2745,186105,0,5340,10702,4604,431,8208,3743,3743,.19926199,,.58454108
2020-08-08,771,602,169,3693,0,259,259,30,231,83,83,622,18237,15323,2914,189798,0,5599,11324,4863,461,8439,3826,3826,.20877336,,.65250963
2020-08-09,173,168,5,834,0,7,31,18,185,66,66,281,18410,15491,2919,190632,0,5606,11605,4894,479,8624,3892,3892,.20743406,,.71428573
2020-08-10,1135,1009,126,5299,0,250,238,16,402,121,121,830,19545,16500,3045,195931,0,5856,12435,5132,495,9026,4013,4013,.21419136,,.50400001
2020-08-11,1320,1141,179,5307,0,303,330,23,169,54,54,700,20865,17641,3224,201238,0,6159,13135,5462,518,9195,4067,4067,.2487281,,.5907591
2020-08-12,1031,918,113,4459,0,189,242,20,207,81,81,833,21896,18559,3337,205697,0,6348,13968,5704,538,9402,4148,4148,.23121776,,.59788358
2020-08-13,1088,985,103,4457,0,215,203,29,157,56,56,874,22984,19544,3440,210154,0,6563,14842,5907,567,9559,4204,4204,.24411039,,.47906977
2020-08-14,1087,948,139,4729,0,259,240,29,228,86,86,882,24071,20492,3579,214883,0,6822,15724,6147,596,9787,4290,4290,.22985832,,.53667957
2020-08-15,961,816,145,3604,0,263,231,30,285,86,86,692,25032,21308,3724,218487,0,7085,16416,6378,626,10072,4376,4376,.26664817,,.5513308
2020-08-16,157,156,1,834,0,3,21,31,143,59,59,193,25189,21464,3725,219321,0,7088,16609,6399,657,10215,4435,4435,.18824939,,.33333334
2020-08-17,1238,1150,88,5493,0,160,207,27,202,71,71,1054,26427,22614,3813,224814,0,7248,17663,6606,684,10417,4506,4506,.22537775,,.55000001
2020-08-18,1095,954,141,4482,0,272,287,25,204,82,82,1087,27522,23568,3954,229296,0,7520,18750,6893,709,10621,4588,4588,.24431057,,.51838237
2020-08-19,1446,1297,149,5014,0,299,287,27,124,50,50,1018,28968,24865,4103,234310,0,7819,19768,7180,736,10745,4638,4638,.28839251,,.49832776
2020-08-20,1685,1532,153,7022,0,258,277,29,271,112,112,1088,30653,26397,4256,241332,0,8077,20856,7457,765,11016,4750,4750,.23996012,,.59302324
2020-08-21,1621,1593,28,6461,0,66,200,26,129,59,59,1051,32274,27990,4284,247793,0,8143,21907,7657,791,11145,4809,4809,.25088996,,.42424244
2020-08-22,1466,1340,126,5502,0,260,271,19,117,54,54,967,33740,29330,4410,253295,0,8403,22874,7928,810,11262,4863,4863,.26644856,,.48461539
2020-08-23,316,316,0,1403,0,0,28,15,106,31,31,138,34056,29646,4410,254698,0,8403,23012,7956,825,11368,4894,4894,.22523165,,
2020-08-24,2987,2903,84,9161,0,206,464,15,130,42,42,1249,37043,32549,4494,263859,0,8609,24261,8420,840,11498,4936,4936,.32605609,,.407767
2020-08-25,1113,1042,71,4522,0,151,178,16,119,34,34,1316,38156,33591,4565,268381,0,8760,25577,8598,856,11617,4970,4970,.24613003,,.47019866
2020-08-26,1101,996,105,4184,0,165,197,15,88,26,26,1446,39257,34587,4670,272565,0,8925,27023,8795,871,11705,4996,4996,.26314533,,.63636363
2020-08-27,1166,1131,35,4693,0,79,133,21,81,33,33,1681,40423,35718,4705,277258,0,9004,28704,8928,892,11786,5029,5029,.24845515,,.44303799
2020-08-28,1391,1233,158,6048,0,332,266,21,88,31,31,1742,41814,36951,4863,283306,0,9336,30446,9194,913,11874,5060,5060,.22999339,,.4759036
2020-08-29,792,719,73,4033,0,235,136,18,65,30,30,1504,42606,37670,4936,287339,0,9571,31950,9330,931,11939,5090,5090,.19637987,,.31063831
2020-08-30,124,124,0,719,0,0,15,18,69,30,30,318,42730,37794,4936,288058,0,9571,32268,9345,949,12008,5120,5120,.17246175,,
2020-08-31,1048,987,61,4908,0,168,166,23,65,24,24,3009,43778,38781,4997,292966,0,9739,35277,9511,972,12073,5144,5144,.21352893,,.36309522
2020-09-01,898,858,40,4390,0,133,128,7,167,39,39,1172,44676,39639,5037,297356,0,9872,36449,9639,979,12240,5183,5183,.20455581,,.30075186
2020-09-02,837,783,54,4065,0,165,131,13,71,24,24,1203,45513,40422,5091,301421,0,10037,37652,9770,992,12311,5207,5207,.20590405,,.32727271
2020-09-03,733,702,31,3627,0,122,108,5,50,15,15,1343,46246,41124,5122,305048,0,10159,38995,9878,997,12361,5222,5222,.20209539,,.25409836
2020-09-04,749,706,43,3661,0,175,134,5,51,20,20,1323,46995,41830,5165,308709,0,10334,40318,10012,1002,12412,5242,5242,.2045889,,.24571429
2020-09-05,487,455,32,2781,0,127,105,10,61,31,31,904,47482,42285,5197,311490,0,10461,41222,10117,1012,12473,5273,5273,.17511687,,.2519685
2020-09-06,115,115,0,1042,0,0,9,6,33,18,18,155,47597,42400,5197,312532,0,10461,41377,10126,1018,12506,5291,5291,.11036468,,
2020-09-07,1237,1196,41,4974,0,190,143,2,56,22,22,1170,48834,43596,5238,317506,0,10651,42547,10269,1020,12562,5313,5313,.2486932,,.21578947
2020-09-08,1273,1250,23,5561,0,106,124,9,47,18,18,972,50107,44846,5261,323067,0,10757,43519,10393,1029,12609,5331,5331,.22891566,,.21698113
2020-09-09,885,845,40,4712,0,178,118,7,37,10,10,915,50992,45691,5301,327779,0,10935,44434,10511,1036,12646,5341,5341,.18781833,,.22471911
2020-09-10,705,673,32,3780,0,164,80,10,72,31,31,782,51697,46364,5333,331559,0,11099,45216,10591,1046,12718,5372,5372,.18650794,,.19512194
2020-09-11,737,717,20,3825,0,111,77,9,35,17,17,906,52434,47081,5353,335384,0,11210,46122,10668,1055,12753,5389,5389,.19267973,,.18018018
2020-09-12,490,473,17,2740,0,76,74,9,34,15,15,569,52924,47554,5370,338124,0,11286,46691,10742,1064,12787,5404,5404,.17883211,,.22368421
2020-09-13,208,208,0,875,0,0,20,4,31,12,12,117,53132,47762,5370,338999,0,11286,46808,10762,1068,12818,5416,5416,.23771429,,
2020-09-14,710,668,42,3923,0,195,94,9,32,11,11,1213,53842,48430,5412,342922,0,11481,48021,10856,1077,12850,5427,5427,.18098395,,.21538462
2020-09-15,567,556,11,3585,0,122,60,7,52,15,15,1239,54409,48986,5423,346507,0,11603,49260,10916,1084,12902,5442,5442,.158159,,.090163931
2020-09-16,516,501,15,3505,0,104,53,3,24,12,12,886,54925,49487,5438,350012,0,11707,50146,10969,1087,12926,5454,5454,.14721826,,.14423077
2020-09-17,375,360,15,2478,0,129,42,7,29,12,12,718,55300,49847,5453,352490,0,11836,50864,11011,1094,12955,5466,5466,.15133172,,.11627907
2020-09-18,346,326,20,2516,0,175,36,5,38,14,14,804,55646,50173,5473,355006,0,12011,51668,11047,1099,12993,5480,5480,.13751987,,.11428571
2020-09-19,283,271,12,2112,0,199,42,2,32,12,12,513,55929,50444,5485,357118,0,12210,52181,11089,1101,13025,5492,5492,.13399622,,.060301509
2020-09-20,62,62,0,405,0,0,3,5,57,19,19,194,55991,50506,5485,357523,0,12210,52375,11092,1106,13082,5511,5511,.15308642,,
2020-09-21,447,422,25,2846,0,219,51,4,29,13,13,838,56438,50928,5510,360369,0,12429,53213,11143,1110,13111,5524,5524,.15706255,,.11415525
2020-09-22,368,342,26,2450,0,231,44,4,18,5,5,672,56806,51270,5536,362819,0,12660,53885,11187,1114,13129,5529,5529,.15020408,,.11255411
2020-09-23,435,412,23,2899,0,171,40,4,20,13,13,593,57241,51682,5559,365718,0,12831,54478,11227,1118,13149,5542,5542,.15005174,,.13450292
2020-09-24,414,391,23,2463,0,135,55,8,25,17,17,417,57655,52073,5582,368181,0,12966,54895,11282,1126,13174,5559,5559,.16808769,,.17037037
2020-09-25,450,430,20,3165,0,137,49,6,24,9,9,367,58105,52503,5602,371346,0,13103,55262,11331,1132,13198,5568,5568,.1421801,,.14598539
2020-09-26,294,289,5,2251,0,62,32,7,16,10,10,296,58399,52792,5607,373597,0,13165,55558,11363,1139,13214,5578,5578,.13060862,,.080645159
2020-09-27,41,41,0,393,0,0,2,3,13,7,7,78,58440,52833,5607,373990,0,13165,55636,11365,1142,13227,5585,5585,.1043257,,
2020-09-28,327,309,18,2784,0,77,42,6,12,4,4,471,58767,53142,5625,376774,0,13242,56107,11407,1148,13239,5589,5589,.1174569,,.23376623
2020-09-29,533,516,17,2933,0,119,63,4,12,3,3,367,59300,53658,5642,379707,0,13361,56474,11470,1152,13251,5592,5592,.18172519,,.14285715
2020-09-30,458,440,18,2971,0,112,29,3,20,9,9,425,59758,54098,5660,382678,0,13473,56899,11499,1155,13271,5601,5601,.15415685,,.16071428
2020-10-01,459,448,11,2858,0,135,34,6,41,9,9,400,60217,54546,5671,385536,0,13608,57299,11533,1161,13312,5610,5610,.16060182,,.081481479
2020-10-02,414,404,10,2513,0,100,26,4,27,6,6,436,60631,54950,5681,388049,0,13708,57735,11559,1165,13339,5616,5616,.16474333,,.1
2020-10-03,406,403,3,2243,0,66,21,2,18,4,4,306,61037,55353,5684,390292,0,13774,58041,11580,1167,13357,5620,5620,.18100758,,.045454547
2020-10-04,100,100,0,507,0,0,7,1,7,1,1,47,61137,55453,5684,390799,0,13774,58088,11587,1168,13364,5621,5621,.19723865,,
2020-10-05,296,289,7,2006,0,89,23,3,21,4,4,350,61433,55742,5691,392805,0,13863,58438,11610,1171,13385,5625,5625,.14755733,,.078651689
2020-10-06,233,211,22,1705,0,85,30,3,12,5,5,546,61666,55953,5713,394510,0,13948,58984,11640,1174,13397,5630,5630,.1366569,,.25882354
2020-10-07,193,187,6,1663,0,86,21,1,12,1,1,456,61859,56140,5719,396173,0,14034,59440,11661,1175,13409,5631,5631,.11605532,,.069767445
2020-10-08,400,396,4,2812,0,97,21,4,11,3,3,463,62259,56536,5723,398985,0,14131,59903,11682,1179,13420,5634,5634,.14224751,,.041237112
2020-10-09,497,495,2,3373,0,40,28,0,10,2,2,434,62756,57031,5725,402358,0,14171,60337,11710,1179,13430,5636,5636,.14734657,,.050000001
2020-10-10,535,531,4,3208,0,75,49,1,24,7,7,400,63291,57562,5729,405566,0,14246,60737,11759,1180,13454,5643,5643,.16677058,,.053333335
2020-10-11,60,60,0,597,0,1,7,1,14,4,4,97,63351,57622,5729,406163,0,14247,60834,11766,1181,13468,5647,5647,.10050251,,0
2020-10-12,911,907,4,3521,0,64,42,1,19,3,3,310,64262,58529,5733,409684,0,14311,61144,11808,1182,13487,5650,5650,.2587333,,.0625
2020-10-13,580,573,7,2345,0,89,51,3,14,6,6,247,64842,59102,5740,412029,0,14400,61391,11859,1185,13501,5656,5656,.24733475,,.078651689
2020-10-14,391,385,6,2351,0,54,30,2,11,4,4,242,65233,59487,5746,414380,0,14454,61633,11889,1187,13512,5660,5660,.1663122,,.11111111
2020-10-15,343,341,2,2139,0,76,22,0,25,11,11,427,65576,59828,5748,416519,0,14530,62060,11911,1187,13537,5671,5671,.1603553,,.02631579
2020-10-16,326,321,5,2209,0,97,22,3,20,10,10,505,65902,60149,5753,418728,0,14627,62565,11933,1190,13557,5681,5681,.14757809,,.051546391
2020-10-17,150,150,0,1484,0,38,11,3,12,7,7,536,66052,60299,5753,420212,0,14665,63101,11944,1193,13569,5688,5688,.10107817,,0
2020-10-18,59,47,12,409,0,13,7,5,8,4,4,61,66111,60346,5765,420621,0,14678,63162,11951,1198,13577,5692,5692,.14425428,,.92307693
2020-10-19,234,230,4,1717,0,46,16,7,7,4,4,790,66345,60576,5769,422338,0,14724,63952,11967,1205,13584,5696,5696,.13628422,,.086956523
2020-10-20,328,317,11,2238,0,88,31,1,31,10,10,523,66673,60893,5780,424576,0,14812,64475,11998,1206,13615,5706,5706,.14655943,,.125
2020-10-21,194,179,15,1402,0,94,33,2,12,5,5,361,66867,61072,5795,425978,0,14906,64836,12031,1208,13627,5711,5711,.13837375,,.15957446
2020-10-22,271,258,13,1821,0,60,25,2,10,4,4,314,67138,61330,5808,427799,0,14966,65150,12056,1210,13637,5715,5715,.14881933,,.21666667
2020-10-23,224,223,1,1788,0,41,11,2,4,1,1,324,67362,61553,5809,429587,0,15007,65474,12067,1212,13641,5716,5716,.12527964,,.024390243
2020-10-24,188,185,3,1394,0,25,17,3,9,2,2,165,67550,61738,5812,430981,0,15032,65639,12084,1215,13650,5718,5718,.1348637,,.12
2020-10-25,31,31,0,342,0,0,3,2,19,0,0,47,67581,61769,5812,431323,0,15032,65686,12087,1217,13669,5718,5718,.090643272,,
2020-10-26,257,246,11,1619,0,60,25,1,21,3,3,370,67838,62015,5823,432942,0,15092,66056,12112,1218,13690,5721,5721,.15873997,,.18333334
2020-10-27,207,206,1,1552,0,60,16,2,7,2,2,393,68045,62221,5824,434494,0,15152,66449,12128,1220,13697,5723,5723,.13337629,,.016666668
2020-10-28,195,189,6,1458,0,74,19,5,12,2,2,209,68240,62410,5830,435952,0,15226,66658,12147,1225,13709,5725,5725,.13374485,,.081081077
2020-10-29,191,189,2,1281,0,64,13,3,14,4,4,292,68431,62599,5832,437233,0,15290,66950,12160,1228,13723,5729,5729,.14910227,,.03125
2020-10-30,182,182,0,1561,0,71,13,2,22,9,9,245,68613,62781,5832,438794,0,15361,67195,12173,1230,13745,5738,5738,.11659193,,0
2020-10-31,144,142,2,1456,0,46,17,0,5,3,3,193,68757,62923,5834,440250,0,15407,67388,12190,1230,13750,5741,5741,.0989011,,.043478262
2020-11-01,51,51,0,388,0,0,11,2,28,5,5,42,68808,62974,5834,440638,0,15407,67430,12201,1232,13778,5746,5746,.13144329,,
2020-11-02,166,163,3,1350,0,63,13,1,13,4,4,245,68974,63137,5837,441988,0,15470,67675,12214,1233,13791,5750,5750,.12296297,,.047619049
2020-11-03,290,278,12,2298,0,39,38,1,9,2,2,222,69264,63415,5849,444286,0,15509,67897,12252,1234,13800,5752,5752,.1261967,,.30769232
2020-11-04,254,253,1,1998,0,36,29,2,5,1,1,201,69518,63668,5850,446284,0,15545,68098,12281,1236,13805,5753,5753,.12712713,,.027777778
2020-11-05,221,214,7,1848,0,94,25,1,13,3,3,207,69739,63882,5857,448132,0,15639,68305,12306,1237,13818,5756,5756,.11958875,,.074468084
2020-11-06,246,244,2,1922,0,46,13,2,14,9,9,179,69985,64126,5859,450054,0,15685,68484,12319,1239,13832,5765,5765,.12799168,,.043478262
2020-11-07,238,236,2,1468,0,34,18,1,17,8,8,151,70223,64362,5861,451522,0,15719,68635,12337,1240,13849,5773,5773,.16212533,,.05882353
2020-11-08,285,283,2,1605,0,36,27,2,8,3,3,49,70508,64645,5863,453127,0,15755,68684,12364,1242,13857,5776,5776,.17757009,,.055555556
2020-11-09,152,151,1,1526,0,47,13,1,12,7,7,176,70660,64796,5864,454653,0,15802,68860,12377,1243,13869,5783,5783,.099606812,,.021276595
2020-11-10,196,195,1,1902,0,96,15,1,21,8,8,262,70856,64991,5865,456555,0,15898,69122,12392,1244,13890,5791,5791,.10304942,,.010416667
2020-11-11,167,165,2,1623,0,120,10,2,17,6,6,243,71023,65156,5867,458178,0,16018,69365,12402,1246,13907,5797,5797,.10289587,,.016666668
2020-11-12,168,160,8,1501,0,156,16,4,13,6,6,211,71191,65316,5875,459679,0,16174,69576,12418,1250,13920,5803,5803,.11192539,,.051282052
2020-11-13,183,181,2,1649,0,141,13,0,9,6,6,242,71374,65497,5877,461328,0,16315,69818,12431,1250,13929,5809,5809,.11097635,,.014184397
2020-11-14,133,129,4,1760,0,215,17,1,13,3,3,220,71507,65626,5881,463088,0,16530,70038,12448,1251,13942,5812,5812,.075568184,,.018604651
2020-11-15,40,40,0,381,0,2,3,1,18,7,7,258,71547,65666,5881,463469,0,16532,70296,12451,1252,13960,5819,5819,.10498688,,0
2020-11-16,178,170,8,1601,0,233,17,1,18,5,5,158,71725,65836,5889,465070,0,16765,70454,12468,1253,13978,5824,5824,.11118051,,.034334764
2020-11-17,170,169,1,1764,0,229,6,4,11,6,6,219,71895,66005,5890,466834,0,16994,70673,12474,1257,13989,5830,5830,.096371882,,.0043668123
2020-11-18,155,146,9,1421,0,229,19,1,8,2,2,175,72050,66151,5899,468255,0,17223,70848,12493,1258,13997,5832,5832,.10907812,,.03930131
2020-11-19,130,118,12,1361,0,163,27,1,11,7,7,169,72180,66269,5911,469616,0,17386,71017,12520,1259,14008,5839,5839,.095518,,.073619634
2020-11-20,157,142,15,1376,0,118,26,0,25,18,18,183,72337,66411,5926,470992,0,17504,71200,12546,1259,14033,5857,5857,.11409884,,.12711865
2020-11-21,123,117,6,1354,0,34,8,1,9,6,6,148,72460,66528,5932,472346,0,17538,71348,12554,1260,14042,5863,5863,.090841949,,.17647059
2020-11-22,97,97,0,545,0,0,20,0,13,6,6,68,72557,66625,5932,472891,0,17538,71416,12574,1260,14055,5869,5869,.17798164,,
2020-11-23,156,149,7,1368,0,59,23,2,17,10,10,158,72713,66774,5939,474259,0,17597,71574,12597,1262,14072,5879,5879,.11403508,,.11864407
2020-11-24,200,195,5,1811,0,61,16,1,9,7,7,173,72913,66969,5944,476070,0,17658,71747,12613,1263,14081,5886,5886,.11043622,,.081967212
2020-11-25,191,182,9,1499,0,72,14,2,7,4,4,148,73104,67151,5953,477569,0,17730,71895,12627,1265,14088,5890,5890,.12741828,,.125
2020-11-26,145,132,13,1623,0,61,20,2,7,2,2,131,73249,67283,5966,479192,0,17791,72026,12647,1267,14095,5892,5892,.089340724,,.21311475
2020-11-27,274,253,21,2054,0,71,30,0,12,7,7,148,73523,67536,5987,481246,0,17862,72174,12677,1267,14107,5899,5899,.13339825,,.29577464
2020-11-28,274,270,4,2017,0,52,11,0,13,9,9,122,73797,67806,5991,483263,0,17914,72296,12688,1267,14120,5908,5908,.13584532,,.07692308
2020-11-29,27,27,0,311,0,2,8,2,11,7,7,90,73824,67833,5991,483574,0,17916,72386,12696,1269,14131,5915,5915,.086816721,,0
2020-11-30,161,151,10,1490,0,62,19,0,14,9,9,164,73985,67984,6001,485064,0,17978,72550,12715,1269,14145,5924,5924,.10805369,,.16129032
2020-12-01,136,117,19,1400,0,60,27,0,21,8,8,198,74121,68101,6020,486464,0,18038,72748,12742,1269,14166,5932,5932,.09714286,,.31666666
2020-12-02,134,131,3,1563,0,38,12,4,4,3,3,201,74255,68232,6023,488027,0,18076,72949,12754,1273,14170,5935,5935,.085732564,,.078947365
2020-12-03,98,88,10,1196,0,41,19,1,10,4,4,136,74353,68320,6033,489223,0,18117,73085,12773,1274,14180,5939,5939,.081939802,,.24390244
2020-12-04,152,134,18,1377,0,63,31,3,10,3,3,259,74505,68454,6051,490600,0,18180,73344,12804,1277,14190,5942,5942,.1103849,,.2857143
2020-12-05,117,115,2,1139,0,57,9,2,15,5,5,256,74622,68569,6053,491739,0,18237,73600,12813,1279,14205,5947,5947,.10272168,,.03508772
2020-12-06,37,37,0,287,0,1,2,0,6,1,1,35,74659,68606,6053,492026,0,18238,73635,12815,1279,14211,5948,5948,.12891985,,0
2020-12-07,111,107,4,1053,0,70,14,1,12,9,9,157,74770,68713,6057,493079,0,18308,73792,12829,1280,14223,5957,5957,.10541311,,.057142857
2020-12-08,73,67,6,795,0,75,10,1,8,6,6,119,74843,68780,6063,493874,0,18383,73911,12839,1281,14231,5963,5963,.091823898,,.079999998
2020-12-09,132,129,3,1498,0,30,11,3,9,5,5,142,74975,68909,6066,495372,0,18413,74053,12850,1284,14240,5968,5968,.088117488,,.1
2020-12-10,110,105,5,1324,0,57,15,2,15,12,12,113,75085,69014,6071,496696,0,18470,74166,12865,1286,14255,5980,5980,.083081573,,.087719299
2020-12-11,218,213,5,1706,0,71,18,1,14,11,11,151,75303,69227,6076,498402,0,18541,74317,12883,1287,14269,5991,5991,.1277843,,.070422538
2020-12-12,160,148,12,1236,0,49,21,1,13,8,8,125,75463,69375,6088,499638,0,18590,74442,12904,1288,14282,5999,5999,.12944984,,.24489796
2020-12-13,32,32,0,292,0,1,4,0,15,9,9,38,75495,69407,6088,499930,0,18591,74480,12908,1288,14297,6008,6008,.10958904,,0
2020-12-14,108,97,11,1127,0,61,26,3,19,14,14,120,75603,69504,6099,501057,0,18652,74600,12934,1291,14316,6022,6022,.095829636,,.18032786
2020-12-15,217,213,4,2074,0,88,24,3,28,20,20,101,75820,69717,6103,503131,0,18740,74701,12958,1294,14344,6042,6042,.10462873,,.045454547
2020-12-16,318,312,6,1935,0,52,18,2,18,12,12,127,76138,70029,6109,505066,0,18792,74828,12976,1296,14362,6054,6054,.16434109,,.11538462
2020-12-17,200,180,20,1815,0,109,28,2,19,19,19,102,76338,70209,6129,506881,0,18901,74930,13004,1298,14381,6073,6073,.11019284,,.18348624
2020-12-18,284,272,12,2231,0,81,22,0,17,12,12,239,76622,70481,6141,509112,0,18982,75169,13026,1298,14398,6085,6085,.12729718,,.14814815
2020-12-19,316,307,9,2393,0,32,18,0,11,7,7,157,76938,70788,6150,511505,0,19014,75326,13044,1298,14409,6092,6092,.13205181,,.28125
2020-12-20,45,45,0,333,0,0,2,0,14,9,9,29,76983,70833,6150,511838,0,19014,75355,13046,1298,14423,6101,6101,.13513513,,
2020-12-21,129,103,26,1174,0,89,35,2,13,9,9,109,77112,70936,6176,513012,0,19103,75464,13081,1300,14436,6110,6110,.10988075,,.29213482
2020-12-22,63,56,7,1052,0,61,10,4,20,15,15,178,77175,70992,6183,514064,0,19164,75642,13091,1304,14456,6125,6125,.05988593,,.1147541
2020-12-23,112,82,30,994,0,85,33,3,27,25,25,290,77287,71074,6213,515058,0,19249,75932,13124,1307,14483,6150,6150,.11267605,,.35294119
2020-12-24,67,59,8,461,0,40,13,1,30,22,22,184,77354,71133,6221,515519,0,19289,76116,13137,1308,14513,6172,6172,.14533623,,.2
2020-12-25,26,26,0,168,0,0,0,2,23,20,20,264,77380,71159,6221,515687,0,19289,76380,13137,1310,14536,6192,6192,.15476191,,
2020-12-26,76,59,17,772,0,59,18,0,27,17,17,306,77456,71218,6238,516459,0,19348,76686,13155,1310,14563,6209,6209,.098445594,,.28813559
2020-12-27,32,32,0,238,0,0,3,0,15,9,9,43,77488,71250,6238,516697,0,19348,76729,13158,1310,14578,6218,6218,.13445379,,
2020-12-28,108,94,14,881,0,58,21,4,38,26,26,114,77596,71344,6252,517578,0,19406,76843,13179,1314,14616,6244,6244,.12258797,,.24137931
2020-12-29,129,96,33,1083,0,86,35,0,28,19,19,92,77725,71440,6285,518661,0,19492,76935,13214,1314,14644,6263,6263,.11911357,,.38372093
2020-12-30,74,52,22,797,0,70,26,1,39,26,26,118,77799,71492,6307,519458,0,19562,77053,13240,1315,14683,6289,6289,.092848182,,.31428573
2020-12-31,71,46,25,753,0,98,29,1,29,22,22,95,77870,71538,6332,520211,0,19660,77148,13269,1316,14712,6311,6311,.094289511,,.25510204
2021-01-01,45,27,18,297,0,83,26,1,67,45,45,66,77915,71565,6350,520508,0,19743,77214,13295,1317,14779,6356,6356,.15151516,,.21686748
2021-01-02,63,59,4,637,0,34,6,0,48,28,28,88,77978,71624,6354,521145,0,19777,77302,13301,1317,14827,6384,6384,.0989011,,.11764706
2021-01-03,33,33,0,319,0,0,3,2,47,35,35,36,78011,71657,6354,521464,0,19777,77338,13304,1319,14874,6419,6419,.10344828,,
2021-01-04,140,110,30,1219,0,138,37,1,56,40,40,113,78151,71767,6384,522683,0,19915,77451,13341,1320,14930,6459,6459,.11484823,,.2173913
2021-01-05,109,89,20,1076,0,89,33,1,43,30,30,98,78260,71856,6404,523759,0,20004,77549,13374,1321,14973,6489,6489,.10130112,,.22471911
2021-01-06,147,97,50,1220,0,156,62,1,55,41,41,85,78407,71953,6454,524979,0,20160,77634,13436,1322,15028,6530,6530,.1204918,,.32051283
2021-01-07,148,118,30,1412,0,154,38,5,56,36,36,52,78555,72071,6484,526391,0,20314,77686,13474,1327,15084,6566,6566,.10481586,,.19480519
2021-01-08,188,145,43,1340,0,139,61,9,82,59,59,20,78743,72216,6527,527731,0,20453,77706,13535,1336,15166,6625,6625,.1402985,,.30935252
2021-01-09,134,110,24,1350,0,137,37,3,64,48,48,76,78877,72326,6551,529081,0,20590,77782,13572,1339,15230,6673,6673,.099259257,,.17518248
2021-01-10,57,57,0,401,0,1,7,4,120,86,86,30,78934,72383,6551,529482,0,20591,77812,13579,1343,15350,6759,6759,.14214464,,0
2021-01-11,169,138,31,1295,0,135,52,4,74,58,58,119,79103,72521,6582,530777,0,20726,77931,13631,1347,15424,6817,6817,.13050193,,.22962964
2021-01-12,163,115,48,1521,0,298,69,2,81,58,58,127,79266,72636,6630,532298,0,21024,78058,13700,1349,15505,6875,6875,.10716633,,.16107382
2021-01-13,161,98,63,1150,0,189,80,7,64,44,44,117,79427,72734,6693,533448,0,21213,78175,13780,1356,15569,6919,6919,.14,,.33333334
2021-01-14,199,147,52,1422,0,184,74,5,67,47,47,130,79626,72881,6745,534870,0,21397,78305,13854,1361,15636,6966,6966,.13994373,,.28260869
2021-01-15,401,357,44,2340,0,221,72,4,107,77,77,145,80027,73238,6789,537210,0,21618,78450,13926,1365,15743,7043,7043,.17136753,,.19909503
2021-01-16,301,198,103,1900,0,358,124,6,83,66,66,105,80328,73436,6892,539110,0,21976,78555,14050,1371,15826,7109,7109,.15842105,,.2877095
2021-01-17,69,64,5,395,0,5,27,5,89,69,69,56,80397,73500,6897,539505,0,21981,78611,14077,1376,15915,7178,7178,.17468354,,1
2021-01-18,267,184,83,1285,0,296,106,8,125,83,83,159,80664,73684,6980,540790,0,22277,78770,14183,1384,16040,7261,7261,.2077821,,.2804054
2021-01-19,199,149,50,1208,0,190,79,6,89,72,72,133,80863,73833,7030,541998,0,22467,78903,14262,1390,16129,7333,7333,.16473509,,.2631579
2021-01-20,312,203,109,1524,0,287,145,7,122,99,99,141,81175,74036,7139,543522,0,22754,79044,14407,1397,16251,7432,7432,.20472442,,.37979093
2021-01-21,273,221,52,1727,0,437,107,12,71,58,58,174,81448,74257,7191,545249,0,23191,79218,14514,1409,16322,7490,7490,.1580776,,.11899313
2021-01-22,286,204,82,1710,0,233,134,9,65,58,58,387,81734,74461,7273,546959,0,23424,79605,14648,1418,16387,7548,7548,.16725147,,.35193133
2021-01-23,262,138,124,1168,0,316,167,10,50,43,43,215,81996,74599,7397,548127,0,23740,79820,14815,1428,16437,7591,7591,.22431506,,.39240506
2021-01-24,89,86,3,464,0,3,27,3,43,37,37,67,82085,74685,7400,548591,0,23743,79887,14842,1431,16480,7628,7628,.19181034,,1
2021-01-25,220,215,5,1408,0,5,89,11,34,30,30,215,82305,74900,7405,549999,0,23748,80102,14931,1442,16514,7658,7658,.15625,,1
2021-01-26,229,159,70,1478,0,177,132,8,19,16,16,186,82534,75059,7475,551477,0,23925,80288,15063,1450,16533,7674,7674,.1549391,,.39548022
2021-01-27,361,203,158,1730,0,330,251,10,7,6,6,250,82895,75262,7633,553207,0,24255,80538,15314,1460,16540,7680,7680,.20867053,,.47878787
2021-01-28,271,169,102,1618,0,233,190,12,7,6,6,257,83166,75431,7735,554825,0,24488,80795,15504,1472,16547,7686,7686,.16749074,,.43776825
2021-01-29,303,166,137,1766,0,269,200,10,2,1,1,251,83469,75597,7872,556591,0,24757,81046,15704,1482,16549,7687,7687,.17157418,,.50929368
2021-01-30,161,122,39,1271,0,68,91,7,0,0,0,247,83630,75719,7911,557862,0,24825,81293,15795,1489,16549,7687,7687,.12667191,,.57352942
2021-01-31,3,3,0,75,0,1,0,6,0,0,0,89,83633,75722,7911,557937,0,24826,81382,15795,1495,16549,7687,7687,.039999999,,0
2021-02-01,,,,,,,,,,,,294,83633,75722,7911,557937,0,24826,81676,15795,1495,16549,7687,7687,,,
2021-02-02,,,,,,,,,,,,226,83633,75722,7911,557937,0,24826,81902,15795,1495,16549,7687,7687,,,
2021-02-03,,,,,,,,,,,,306,83633,75722,7911,557937,0,24826,82208,15795,1495,16549,7687,7687,,,
2021-02-04,,,,,,,,,,,,263,83633,75722,7911,557937,0,24826,82471,15795,1495,16549,7687,7687,,,
2021-02-05,,,,,,,,,,,,272,83633,75722,7911,557937,0,24826,82743,15795,1495,16549,7687,7687,,,
2021-02-06,,,,,,,,,,,,267,83633,75722,7911,557937,0,24826,83010,15795,1495,16549,7687,7687,,,
2021-02-07,,,,,,,,,,,,18,83633,75722,7911,557937,0,24826,83028,15795,1495,16549,7687,7687,,,
2021-02-08,,,,,,,,,,,,92,83633,75722,7911,557937,0,24826,83120,15795,1495,16549,7687,7687,,,
2021-02-09,,,,,,,,,,,,133,83633,75722,7911,557937,0,24826,83253,15795,1495,16549,7687,7687,,,
2021-02-10,,,,,,,,,,,,276,83633,75722,7911,557937,0,24826,83529,15795,1495,16549,7687,7687,,,
2021-02-11,,,,,,,,,,,,184,83633,75722,7911,557937,0,24826,83713,15795,1495,16549,7687,7687,,,
2021-02-12,,,,,,,,,,,,195,83633,75722,7911,557937,0,24826,83908,15795,1495,16549,7687,7687,,,
2021-02-13,,,,,,,,,,,,91,83633,75722,7911,557937,0,24826,83999,15795,1495,16549,7687,7687,,,
,,,,,,,,,0,0,0,0,83633,75722,7911,557937,0,24826,83999,15795,1495,16549,7687,7687,,,
