fecha,positivo,positivo_rapida,positivo_molecular,muestra,muestra_rapida,muestra_molecular,sintomaticos,defunciones,inicio,inicio_molecular,inicio_rapida,recuperado,total_positivo,total_positivo_rapida,total_positivo_molecular,total_muestra,total_muestra_rapida,total_muestra_molecular,total_recuperado,total_sintomaticos,total_defunciones,total_inicio,total_inicio_molecular,total_inicio_rapida
2020-03-06,,,,,,,,,1,1,1,,0,0,0,0,0,0,0,0,0,1,1,1
2020-03-07,,,,,,,,,2,1,1,,0,0,0,0,0,0,0,0,0,3,2,2
2020-03-08,,,,,,,,,1,1,1,,0,0,0,0,0,0,0,0,0,4,3,3
2020-03-09,,,,,,,,,1,1,1,,0,0,0,0,0,0,0,0,0,5,4,4
2020-03-10,,,,,,,,,2,2,2,,0,0,0,0,0,0,0,0,0,7,6,6
2020-03-11,,,,,,,,,0,0,0,,0,0,0,0,0,0,0,0,0,7,6,6
2020-03-12,,,,,,,,,0,0,0,,0,0,0,0,0,0,0,0,0,7,6,6
2020-03-13,1,0,1,3,0,3,1,0,0,0,0,,1,0,1,3,0,3,0,1,0,7,6,6
2020-03-14,0,0,0,1,0,0,0,0,2,1,1,,1,0,1,4,0,3,0,1,0,9,7,7
2020-03-15,0,0,0,21,0,18,0,0,4,3,3,,1,0,1,25,0,21,0,1,0,13,10,10
2020-03-16,0,0,0,2,0,2,0,0,3,2,2,,1,0,1,27,0,23,0,1,0,16,12,12
2020-03-17,0,0,0,1,0,1,0,0,4,2,2,,1,0,1,28,0,24,0,1,0,20,14,14
2020-03-18,3,0,3,16,0,16,3,0,5,4,4,,4,0,4,44,0,40,0,4,0,25,18,18
2020-03-19,0,0,0,3,0,1,0,0,2,2,2,,4,0,4,47,0,41,0,4,0,27,20,20
2020-03-20,1,1,0,16,0,14,0,0,7,5,5,,5,1,4,63,0,55,0,4,0,34,25,25
2020-03-21,0,0,0,12,0,12,0,0,4,3,3,,5,1,4,75,0,67,0,4,0,38,28,28
2020-03-22,3,1,2,5,0,4,2,0,4,3,3,,8,2,6,80,0,71,0,6,0,42,31,31
2020-03-23,0,0,0,20,0,20,0,0,3,2,2,,8,2,6,100,0,91,0,6,0,45,33,33
2020-03-24,4,0,4,14,0,13,4,1,8,7,7,,12,2,10,114,0,104,0,10,1,53,40,40
2020-03-25,1,1,0,2,0,0,0,0,6,6,6,,13,3,10,116,0,104,0,10,1,59,46,46
2020-03-26,0,0,0,1,0,1,0,0,5,4,4,,13,3,10,117,0,105,0,10,1,64,50,50
2020-03-27,2,0,2,20,0,19,2,1,5,4,4,2,15,3,12,137,0,124,2,12,2,69,54,54
2020-03-28,16,0,16,33,0,32,16,0,2,1,1,,31,3,28,170,0,156,2,28,2,71,55,55
2020-03-29,0,0,0,1,0,0,0,0,4,2,2,,31,3,28,171,0,156,2,28,2,75,57,57
2020-03-30,6,0,6,27,0,24,6,0,4,2,2,,37,3,34,198,0,180,2,34,2,79,59,59
2020-03-31,4,0,4,27,0,27,4,0,3,3,3,,41,3,38,225,0,207,2,38,2,82,62,62
2020-04-01,1,1,0,3,0,0,0,0,10,0,0,4,42,4,38,228,0,207,6,38,2,92,62,62
2020-04-02,7,1,6,19,0,15,6,1,4,1,1,,49,5,44,247,0,222,6,44,3,96,63,63
2020-04-03,4,0,4,18,0,17,4,0,4,1,1,,53,5,48,265,0,239,6,48,3,100,64,64
2020-04-04,12,8,4,654,0,8,5,0,7,3,3,,65,13,52,919,0,247,6,53,3,107,67,67
2020-04-05,2,0,2,37,0,17,2,0,7,2,2,3,67,13,54,956,0,264,9,55,3,114,69,69
2020-04-06,1,1,0,18,0,7,0,0,4,1,1,,68,14,54,974,0,271,9,55,3,118,70,70
2020-04-07,1,1,0,182,0,4,0,0,4,3,3,4,69,15,54,1156,0,275,13,55,3,122,73,73
2020-04-08,5,3,2,20,0,11,4,0,2,0,0,1,74,18,56,1176,0,286,14,59,3,124,73,73
2020-04-09,2,0,2,49,0,10,2,0,2,2,2,,76,18,58,1225,0,296,14,61,3,126,75,75
2020-04-10,3,3,0,17,0,0,0,0,8,2,2,2,79,21,58,1242,0,296,16,61,3,134,77,77
2020-04-11,39,38,1,85,0,8,3,0,3,0,0,22,118,59,59,1327,0,304,38,64,3,137,77,77
2020-04-12,0,0,0,7,0,0,0,0,2,1,1,,118,59,59,1334,0,304,38,64,3,139,78,78
2020-04-13,1,0,1,47,0,7,0,0,2,0,0,6,119,59,60,1381,0,311,44,64,3,141,78,78
2020-04-14,5,3,2,31,0,8,1,0,2,0,0,5,124,62,62,1412,0,319,49,65,3,143,78,78
2020-04-15,1,1,0,157,0,0,0,0,11,1,1,3,125,63,62,1569,0,319,52,65,3,154,79,79
2020-04-16,8,6,2,525,0,6,2,0,3,0,0,7,133,69,64,2094,0,325,59,67,3,157,79,79
2020-04-17,11,10,1,394,0,9,1,0,10,0,0,6,144,79,65,2488,0,334,65,68,3,167,79,79
2020-04-18,14,14,0,622,0,28,2,0,7,1,1,38,158,93,65,3110,0,362,103,70,3,174,80,80
2020-04-19,0,0,0,326,0,0,0,0,8,1,1,2,158,93,65,3436,0,362,105,70,3,182,81,81
2020-04-20,18,18,0,742,0,2,4,0,20,1,1,1,176,111,65,4178,0,364,106,74,3,202,82,82
2020-04-21,6,6,0,502,0,11,3,0,13,0,0,3,182,117,65,4680,0,375,109,77,3,215,82,82
2020-04-22,23,22,1,516,0,5,5,1,10,1,1,3,205,139,66,5196,0,380,112,82,4,225,83,83
2020-04-23,23,21,2,347,0,3,2,0,12,1,1,6,228,160,68,5543,0,383,118,84,4,237,84,84
2020-04-24,9,8,1,367,0,37,2,0,11,0,0,10,237,168,69,5910,0,420,128,86,4,248,84,84
2020-04-25,13,13,0,239,0,8,1,0,8,0,0,18,250,181,69,6149,0,428,146,87,4,256,84,84
2020-04-26,0,0,0,18,0,7,0,0,2,1,1,,250,181,69,6167,0,435,146,87,4,258,85,85
2020-04-27,14,14,0,240,0,13,2,0,9,2,2,16,264,195,69,6407,0,448,162,89,4,267,87,87
2020-04-28,21,21,0,203,0,12,3,0,11,2,2,7,285,216,69,6610,0,460,169,92,4,278,89,89
2020-04-29,23,21,2,425,0,29,9,0,10,0,0,11,308,237,71,7035,0,489,180,101,4,288,89,89
2020-04-30,39,39,0,423,0,12,10,0,12,0,0,14,347,276,71,7458,0,501,194,111,4,300,89,89
2020-05-01,5,5,0,95,0,29,1,0,29,1,1,4,352,281,71,7553,0,530,198,112,4,329,90,90
2020-05-02,16,16,0,170,0,4,4,0,11,2,2,13,368,297,71,7723,0,534,211,116,4,340,92,92
2020-05-03,3,3,0,44,0,0,1,0,6,2,2,,371,300,71,7767,0,534,211,117,4,346,94,94
2020-05-04,11,10,1,440,0,21,4,0,9,2,2,16,382,310,72,8207,0,555,227,121,4,355,96,96
2020-05-05,29,29,0,663,0,22,4,0,20,3,3,22,411,339,72,8870,0,577,249,125,4,375,99,99
2020-05-06,55,51,4,1017,0,11,7,0,16,3,3,25,466,390,76,9887,0,588,274,132,4,391,102,102
2020-05-07,47,44,3,552,0,11,7,1,9,2,2,49,513,434,79,10439,0,599,323,139,5,400,104,104
2020-05-08,47,46,1,679,0,16,8,0,4,0,0,9,560,480,80,11118,0,615,332,147,5,404,104,104
2020-05-09,14,14,0,326,0,14,1,0,7,1,1,16,574,494,80,11444,0,629,348,148,5,411,105,105
2020-05-10,2,2,0,98,0,0,1,1,16,0,0,3,576,496,80,11542,0,629,351,149,6,427,105,105
2020-05-11,63,63,0,851,0,15,5,0,10,1,1,9,639,559,80,12393,0,644,360,154,6,437,106,106
2020-05-12,44,43,1,735,0,30,2,0,16,7,7,15,683,602,81,13128,0,674,375,156,6,453,113,113
2020-05-13,76,74,2,1176,0,10,8,1,8,5,5,40,759,676,83,14304,0,684,415,164,7,461,118,118
2020-05-14,39,39,0,426,0,23,5,0,5,2,2,23,798,715,83,14730,0,707,438,169,7,466,120,120
2020-05-15,10,9,1,450,0,15,4,2,17,5,5,22,808,724,84,15180,0,722,460,173,9,483,125,125
2020-05-16,16,16,0,399,0,29,1,0,12,5,5,7,824,740,84,15579,0,751,467,174,9,495,130,130
2020-05-17,1,1,0,62,0,0,0,0,9,3,3,1,825,741,84,15641,0,751,468,174,9,504,133,133
2020-05-18,19,18,1,349,0,14,2,0,16,6,6,50,844,759,85,15990,0,765,518,176,9,520,139,139
2020-05-19,53,53,0,944,0,18,3,1,6,3,3,34,897,812,85,16934,0,783,552,179,10,526,142,142
2020-05-20,37,36,1,711,0,15,3,0,17,4,4,69,934,848,86,17645,0,798,621,182,10,543,146,146
2020-05-21,49,44,5,950,0,16,12,0,3,1,1,49,983,892,91,18595,0,814,670,194,10,546,147,147
2020-05-22,47,44,3,883,0,11,5,0,13,6,6,33,1030,936,94,19478,0,825,703,199,10,559,153,153
2020-05-23,34,33,1,505,0,15,4,0,4,0,0,16,1064,969,95,19983,0,840,719,203,10,563,153,153
2020-05-24,5,5,0,106,0,0,1,1,12,3,3,2,1069,974,95,20089,0,840,721,204,11,575,156,156
2020-05-25,45,38,7,691,0,24,12,0,26,7,7,25,1114,1012,102,20780,0,864,746,216,11,601,163,163
2020-05-26,32,29,3,739,0,18,4,0,11,5,5,67,1146,1041,105,21519,0,882,813,220,11,612,168,168
2020-05-27,46,44,2,1009,0,11,5,0,9,2,2,48,1192,1085,107,22528,0,893,861,225,11,621,170,170
2020-05-28,53,53,0,943,0,1,5,0,15,3,3,42,1245,1138,107,23471,0,894,903,230,11,636,173,173
2020-05-29,66,62,4,835,0,23,6,0,16,12,12,27,1311,1200,111,24306,0,917,930,236,11,652,185,185
2020-05-30,29,29,0,582,0,0,3,0,16,3,3,28,1340,1229,111,24888,0,917,958,239,11,668,188,188
2020-05-31,4,4,0,158,0,0,1,0,13,10,10,3,1344,1233,111,25046,0,917,961,240,11,681,198,198
2020-06-01,44,41,3,996,0,39,8,0,37,12,12,24,1388,1274,114,26042,0,956,985,248,11,718,210,210
2020-06-02,43,38,5,835,0,17,8,0,20,10,10,20,1431,1312,119,26877,0,973,1005,256,11,738,220,220
2020-06-03,46,42,4,742,0,9,11,2,18,6,6,45,1477,1354,123,27619,0,982,1050,267,13,756,226,226
2020-06-04,67,65,2,1280,0,8,16,2,26,13,13,55,1544,1419,125,28899,0,990,1105,283,15,782,239,239
2020-06-05,44,38,6,1081,0,11,9,1,17,6,6,63,1588,1457,131,29980,0,1001,1168,292,16,799,245,245
2020-06-06,78,44,34,895,0,41,35,0,24,12,12,30,1666,1501,165,30875,0,1042,1198,327,16,823,257,257
2020-06-07,27,14,13,212,0,13,17,1,29,20,20,6,1693,1515,178,31087,0,1055,1204,344,17,852,277,277
2020-06-08,47,46,1,1472,0,8,4,0,36,12,12,53,1740,1561,179,32559,0,1063,1257,348,17,888,289,289
2020-06-09,109,103,6,1709,0,18,9,1,12,2,2,42,1849,1664,185,34268,0,1081,1299,357,18,900,291,291
2020-06-10,50,44,6,1433,0,26,9,0,26,16,16,37,1899,1708,191,35701,0,1107,1336,366,18,926,307,307
2020-06-11,42,40,2,1222,0,19,10,1,12,8,8,57,1941,1748,193,36923,0,1126,1393,376,19,938,315,315
2020-06-12,75,47,28,1624,0,50,32,1,23,12,12,49,2016,1795,221,38547,0,1176,1442,408,20,961,327,327
2020-06-13,36,27,9,1274,0,29,13,2,19,15,15,36,2052,1822,230,39821,0,1205,1478,421,22,980,342,342
2020-06-14,16,16,0,120,0,0,1,0,18,9,9,13,2068,1838,230,39941,0,1205,1491,422,22,998,351,351
2020-06-15,67,63,4,1493,0,21,10,2,37,10,10,41,2135,1901,234,41434,0,1226,1532,432,24,1035,361,361
2020-06-16,63,57,6,1682,0,27,11,1,18,4,4,101,2198,1958,240,43116,0,1253,1633,443,25,1053,365,365
2020-06-17,60,42,18,1677,0,36,23,4,22,5,5,55,2258,2000,258,44793,0,1289,1688,466,29,1075,370,370
2020-06-18,44,38,6,1655,0,28,10,0,22,7,7,51,2302,2038,264,46448,0,1317,1739,476,29,1097,377,377
2020-06-19,59,49,10,1496,0,24,13,2,16,7,7,59,2361,2087,274,47944,0,1341,1798,489,31,1113,384,384
2020-06-20,65,36,29,1248,0,43,33,0,35,14,14,79,2426,2123,303,49192,0,1384,1877,522,31,1148,398,398
2020-06-21,6,6,0,257,0,0,0,0,26,11,11,27,2432,2129,303,49449,0,1384,1904,522,31,1174,409,409
2020-06-22,68,68,0,1555,0,15,3,0,20,12,12,73,2500,2197,303,51004,0,1399,1977,525,31,1194,421,421
2020-06-23,114,107,7,1878,0,18,9,0,15,7,7,73,2614,2304,310,52882,0,1417,2050,534,31,1209,428,428
2020-06-24,64,64,0,1128,0,0,11,0,26,10,10,56,2678,2368,310,54010,0,1417,2106,545,31,1235,438,438
2020-06-25,83,75,8,1805,0,16,13,3,21,7,7,45,2761,2443,318,55815,0,1433,2151,558,34,1256,445,445
2020-06-26,103,86,17,2585,0,33,26,1,28,11,11,74,2864,2529,335,58400,0,1466,2225,584,35,1284,456,456
2020-06-27,86,82,4,1756,0,26,16,0,23,11,11,36,2950,2611,339,60156,0,1492,2261,600,35,1307,467,467
2020-06-28,29,28,1,337,0,1,1,3,33,14,14,7,2979,2639,340,60493,0,1493,2268,601,38,1340,481,481
2020-06-29,96,85,11,1695,0,19,17,0,23,12,12,58,3075,2724,351,62188,0,1512,2326,618,38,1363,493,493
2020-06-30,93,79,14,2569,0,35,17,1,25,14,14,92,3168,2803,365,64757,0,1547,2418,635,39,1388,507,507
2020-07-01,124,120,4,3090,0,10,16,3,91,28,28,77,3292,2923,369,67847,0,1557,2495,651,42,1479,535,535
2020-07-02,151,135,16,3044,0,28,43,3,60,20,20,83,3443,3058,385,70891,0,1585,2578,694,45,1539,555,555
2020-07-03,135,120,15,3479,0,36,17,2,61,30,30,78,3578,3178,400,74370,0,1621,2656,711,47,1600,585,585
2020-07-04,98,96,2,2345,0,17,10,1,55,27,27,112,3676,3274,402,76715,0,1638,2768,721,48,1655,612,612
2020-07-05,45,32,13,694,0,28,18,2,96,50,50,15,3721,3306,415,77409,0,1666,2783,739,50,1751,662,662
2020-07-06,160,145,15,2529,0,23,24,0,94,57,57,105,3881,3451,430,79938,0,1689,2888,763,50,1845,719,719
2020-07-07,148,126,22,3264,0,45,32,1,76,43,43,92,4029,3577,452,83202,0,1734,2980,795,51,1921,762,762
2020-07-08,128,112,16,2225,0,37,27,2,61,30,30,101,4157,3689,468,85427,0,1771,3081,822,53,1982,792,792
2020-07-09,132,110,22,2554,0,37,28,3,51,29,29,130,4289,3799,490,87981,0,1808,3211,850,56,2033,821,821
2020-07-10,188,147,41,2761,0,47,55,6,156,84,84,124,4477,3946,531,90742,0,1855,3335,905,62,2189,905,905
2020-07-11,180,133,47,2219,0,61,58,5,100,58,58,80,4657,4079,578,92961,0,1916,3415,963,67,2289,963,963
2020-07-12,37,37,0,491,0,0,2,5,98,58,58,36,4694,4116,578,93452,0,1916,3451,965,72,2387,1021,1021
2020-07-13,256,198,58,3025,0,90,72,1,111,64,64,133,4950,4314,636,96477,0,2006,3584,1037,73,2498,1085,1085
2020-07-14,303,248,55,3075,0,74,76,3,117,48,48,137,5253,4562,691,99552,0,2080,3721,1113,76,2615,1133,1133
2020-07-15,278,219,59,3878,0,99,76,4,174,84,84,126,5531,4781,750,103430,0,2179,3847,1189,80,2789,1217,1217
2020-07-16,323,285,38,3213,0,48,64,6,119,66,66,126,5854,5066,788,106643,0,2227,3973,1253,86,2908,1283,1283
2020-07-17,345,285,60,3781,0,77,76,5,158,90,90,172,6199,5351,848,110424,0,2304,4145,1329,91,3066,1373,1373
2020-07-18,267,188,79,3243,0,142,101,6,182,103,103,135,6466,5539,927,113667,0,2446,4280,1430,97,3248,1476,1476
2020-07-19,55,55,0,658,0,1,8,4,176,95,95,52,6521,5594,927,114325,0,2447,4332,1438,101,3424,1571,1571
2020-07-20,364,324,40,3741,0,56,100,7,316,148,148,211,6885,5918,967,118066,0,2503,4543,1538,108,3740,1719,1719
2020-07-21,419,294,125,3414,0,181,157,4,199,109,109,239,7304,6212,1092,121480,0,2684,4782,1695,112,3939,1828,1828
2020-07-22,421,306,115,3663,0,194,166,18,238,130,130,180,7725,6518,1207,125143,0,2878,4962,1861,130,4177,1958,1958
2020-07-23,373,323,50,3360,0,63,108,9,173,94,94,274,8098,6841,1257,128503,0,2941,5236,1969,139,4350,2052,2052
2020-07-24,465,383,82,4420,0,134,135,6,203,119,119,301,8563,7224,1339,132923,0,3075,5537,2104,145,4553,2171,2171
2020-07-25,523,377,146,3227,0,249,190,12,260,124,124,224,9086,7601,1485,136150,0,3324,5761,2294,157,4813,2295,2295
2020-07-26,226,119,107,1075,0,169,128,9,245,130,130,51,9312,7720,1592,137225,0,3493,5812,2422,166,5058,2425,2425
2020-07-27,532,476,56,4250,0,87,151,17,340,176,176,333,9844,8196,1648,141475,0,3580,6145,2573,183,5398,2601,2601
2020-07-28,336,317,19,2252,0,57,65,23,318,136,136,342,10180,8513,1667,143727,0,3637,6487,2638,206,5716,2737,2737
2020-07-29,686,535,151,4051,0,253,226,12,219,106,106,374,10866,9048,1818,147778,0,3890,6861,2864,218,5935,2843,2843
2020-07-30,691,529,162,4517,0,259,246,23,209,104,104,321,11557,9577,1980,152295,0,4149,7182,3110,241,6144,2947,2947
2020-07-31,721,618,103,5062,0,178,186,33,208,107,107,403,12278,10195,2083,157357,0,4327,7585,3296,274,6352,3054,3054
2020-08-01,593,534,59,3736,0,93,118,28,509,201,201,378,12871,10729,2142,161093,0,4420,7963,3414,302,6861,3255,3255
2020-08-02,188,187,1,1040,0,1,56,22,213,83,83,102,13059,10916,2143,162133,0,4421,8065,3470,324,7074,3338,3338
2020-08-03,906,799,107,5308,0,175,204,19,247,74,74,461,13965,11715,2250,167441,0,4596,8526,3674,343,7321,3412,3412
2020-08-04,862,805,57,5119,0,90,162,21,202,73,73,434,14827,12520,2307,172560,0,4686,8960,3836,364,7523,3485,3485
2020-08-05,839,685,154,4255,0,213,284,15,258,77,77,581,15666,13205,2461,176815,0,4899,9541,4120,379,7781,3562,3562
2020-08-06,879,715,164,4716,0,265,250,27,196,78,78,526,16545,13920,2625,181531,0,5164,10067,4370,406,7977,3640,3640
2020-08-07,918,797,121,4610,0,210,235,27,203,94,94,631,17463,14717,2746,186141,0,5374,10698,4605,433,8180,3734,3734
2020-08-08,771,602,169,3693,0,260,259,30,231,83,83,622,18234,15319,2915,189834,0,5634,11320,4864,463,8411,3817,3817
2020-08-09,173,168,5,834,0,7,31,18,185,66,66,281,18407,15487,2920,190668,0,5641,11601,4895,481,8596,3883,3883
2020-08-10,1135,1009,126,5298,0,250,238,16,402,121,121,830,19542,16496,3046,195966,0,5891,12431,5133,497,8998,4004,4004
2020-08-11,1320,1141,179,5312,0,308,330,23,169,54,54,700,20862,17637,3225,201278,0,6199,13131,5463,520,9167,4058,4058
2020-08-12,1031,919,112,4462,0,191,241,20,206,80,80,833,21893,18556,3337,205740,0,6390,13964,5704,540,9373,4138,4138
2020-08-13,1088,985,103,4458,0,215,203,29,156,55,55,874,22981,19541,3440,210198,0,6605,14838,5907,569,9529,4193,4193
2020-08-14,1087,948,139,4729,0,260,240,29,228,86,86,883,24068,20489,3579,214927,0,6865,15721,6147,598,9757,4279,4279
2020-08-15,961,816,145,3608,0,266,231,30,284,85,85,692,25029,21305,3724,218535,0,7131,16413,6378,628,10041,4364,4364
2020-08-16,157,156,1,834,0,3,21,31,143,59,59,193,25186,21461,3725,219369,0,7134,16606,6399,659,10184,4423,4423
2020-08-17,1239,1151,88,5496,0,161,207,27,199,68,68,1054,26425,22612,3813,224865,0,7295,17660,6606,686,10383,4491,4491
2020-08-18,1095,954,141,4486,0,275,287,25,204,82,82,1087,27520,23566,3954,229351,0,7570,18747,6893,711,10587,4573,4573
2020-08-19,1446,1297,149,5015,0,301,287,27,124,50,50,1018,28966,24863,4103,234366,0,7871,19765,7180,738,10711,4623,4623
2020-08-20,1684,1531,153,7023,0,260,277,29,271,112,112,1088,30650,26394,4256,241389,0,8131,20853,7457,767,10982,4735,4735
2020-08-21,1621,1593,28,6461,0,66,200,26,128,59,59,1051,32271,27987,4284,247850,0,8197,21904,7657,793,11110,4794,4794
2020-08-22,1467,1340,127,5504,0,262,272,19,118,54,54,967,33738,29327,4411,253354,0,8459,22871,7929,812,11228,4848,4848
2020-08-23,316,316,0,1403,0,0,28,15,106,31,31,138,34054,29643,4411,254757,0,8459,23009,7957,827,11334,4879,4879
2020-08-24,2987,2903,84,9166,0,209,465,15,130,42,42,1250,37041,32546,4495,263923,0,8668,24259,8422,842,11464,4921,4921
2020-08-25,1113,1042,71,4524,0,153,178,16,119,34,34,1316,38154,33588,4566,268447,0,8821,25575,8600,858,11583,4955,4955
2020-08-26,1101,996,105,4184,0,165,197,15,88,26,26,1446,39255,34584,4671,272631,0,8986,27021,8797,873,11671,4981,4981
2020-08-27,1166,1131,35,4693,0,79,133,21,82,33,33,1680,40421,35715,4706,277324,0,9065,28701,8930,894,11753,5014,5014
2020-08-28,1391,1233,158,6050,0,334,266,21,87,31,31,1742,41812,36948,4864,283374,0,9399,30443,9196,915,11840,5045,5045
2020-08-29,792,719,73,4036,0,236,136,18,65,30,30,1504,42604,37667,4937,287410,0,9635,31947,9332,933,11905,5075,5075
2020-08-30,124,124,0,719,0,0,15,18,69,30,30,318,42728,37791,4937,288129,0,9635,32265,9347,951,11974,5105,5105
2020-08-31,1060,999,61,4990,0,168,168,23,65,24,24,3009,43788,38790,4998,293119,0,9803,35274,9515,974,12039,5129,5129
2020-09-01,898,858,40,4390,0,133,128,7,166,39,39,1172,44686,39648,5038,297509,0,9936,36446,9643,981,12205,5168,5168
2020-09-02,837,783,54,4066,0,165,131,13,71,24,24,1203,45523,40431,5092,301575,0,10101,37649,9774,994,12276,5192,5192
2020-09-03,733,702,31,3628,0,123,108,5,49,14,14,1343,46256,41133,5123,305203,0,10224,38992,9882,999,12325,5206,5206
2020-09-04,749,706,43,3662,0,176,134,5,51,20,20,1323,47005,41839,5166,308865,0,10400,40315,10016,1004,12376,5226,5226
2020-09-05,486,454,32,2780,0,127,105,10,59,30,30,905,47491,42293,5198,311645,0,10527,41220,10121,1014,12435,5256,5256
2020-09-06,115,115,0,1042,0,0,9,6,33,18,18,155,47606,42408,5198,312687,0,10527,41375,10130,1020,12468,5274,5274
2020-09-07,1237,1196,41,4977,0,193,143,2,55,22,22,1179,48843,43604,5239,317664,0,10720,42554,10273,1022,12523,5296,5296
2020-09-08,1273,1250,23,5561,0,106,124,9,46,17,17,972,50116,44854,5262,323225,0,10826,43526,10397,1031,12569,5313,5313
2020-09-09,885,845,40,4714,0,180,118,7,37,10,10,915,51001,45699,5302,327939,0,11006,44441,10515,1038,12606,5323,5323
2020-09-10,705,673,32,3782,0,166,80,10,71,31,31,782,51706,46372,5334,331721,0,11172,45223,10595,1048,12677,5354,5354
2020-09-11,737,717,20,3828,0,113,77,9,35,17,17,906,52443,47089,5354,335549,0,11285,46129,10672,1057,12712,5371,5371
2020-09-12,490,473,17,2741,0,77,74,9,34,15,15,568,52933,47562,5371,338290,0,11362,46697,10746,1066,12746,5386,5386
2020-09-13,208,208,0,875,0,0,20,4,31,12,12,117,53141,47770,5371,339165,0,11362,46814,10766,1070,12777,5398,5398
2020-09-14,710,668,42,3925,0,196,94,9,32,11,11,1216,53851,48438,5413,343090,0,11558,48030,10860,1079,12809,5409,5409
2020-09-15,567,556,11,3585,0,122,60,7,51,14,14,1239,54418,48994,5424,346675,0,11680,49269,10920,1086,12860,5423,5423
2020-09-16,517,502,15,3505,0,104,53,3,23,12,12,886,54935,49496,5439,350180,0,11784,50155,10973,1089,12883,5435,5435
2020-09-17,375,360,15,2479,0,130,42,7,29,12,12,718,55310,49856,5454,352659,0,11914,50873,11015,1096,12912,5447,5447
2020-09-18,346,326,20,2516,0,175,36,5,38,14,14,804,55656,50182,5474,355175,0,12089,51677,11051,1101,12950,5461,5461
2020-09-19,283,271,12,2111,0,199,42,2,32,12,12,513,55939,50453,5486,357286,0,12288,52190,11093,1103,12982,5473,5473
2020-09-20,62,62,0,405,0,0,3,5,57,19,19,194,56001,50515,5486,357691,0,12288,52384,11096,1108,13039,5492,5492
2020-09-21,447,422,25,2848,0,220,51,4,29,13,13,838,56448,50937,5511,360539,0,12508,53222,11147,1112,13068,5505,5505
2020-09-22,368,342,26,2451,0,232,44,4,18,5,5,672,56816,51279,5537,362990,0,12740,53894,11191,1116,13086,5510,5510
2020-09-23,435,412,23,2901,0,173,40,4,19,12,12,594,57251,51691,5560,365891,0,12913,54488,11231,1120,13105,5522,5522
2020-09-24,414,391,23,2464,0,135,55,8,25,17,17,417,57665,52082,5583,368355,0,13048,54905,11286,1128,13130,5539,5539
2020-09-25,450,430,20,3166,0,139,49,6,23,9,9,367,58115,52512,5603,371521,0,13187,55272,11335,1134,13153,5548,5548
2020-09-26,294,289,5,2253,0,62,32,7,16,10,10,296,58409,52801,5608,373774,0,13249,55568,11367,1141,13169,5558,5558
2020-09-27,41,41,0,393,0,0,2,3,13,7,7,78,58450,52842,5608,374167,0,13249,55646,11369,1144,13182,5565,5565
2020-09-28,327,309,18,2784,0,77,42,6,12,4,4,471,58777,53151,5626,376951,0,13326,56117,11411,1150,13194,5569,5569
2020-09-29,533,516,17,2934,0,120,63,4,12,3,3,367,59310,53667,5643,379885,0,13446,56484,11474,1154,13206,5572,5572
2020-09-30,458,440,18,2973,0,113,29,3,20,9,9,425,59768,54107,5661,382858,0,13559,56909,11503,1157,13226,5581,5581
2020-10-01,459,448,11,2859,0,136,33,6,41,9,9,400,60227,54555,5672,385717,0,13695,57309,11536,1163,13267,5590,5590
2020-10-02,414,404,10,2512,0,100,27,4,27,6,6,436,60641,54959,5682,388229,0,13795,57745,11563,1167,13294,5596,5596
2020-10-03,406,403,3,2243,0,66,21,2,18,4,4,306,61047,55362,5685,390472,0,13861,58051,11584,1169,13312,5600,5600
2020-10-04,100,100,0,507,0,0,7,1,7,1,1,47,61147,55462,5685,390979,0,13861,58098,11591,1170,13319,5601,5601
2020-10-05,296,289,7,2009,0,90,23,3,21,4,4,350,61443,55751,5692,392988,0,13951,58448,11614,1173,13340,5605,5605
2020-10-06,233,211,22,1704,0,85,30,3,12,5,5,546,61676,55962,5714,394692,0,14036,58994,11644,1176,13352,5610,5610
2020-10-07,193,187,6,1663,0,87,21,1,12,1,1,456,61869,56149,5720,396355,0,14123,59450,11665,1177,13364,5611,5611
2020-10-08,400,396,4,2812,0,98,21,4,11,3,3,463,62269,56545,5724,399167,0,14221,59913,11686,1181,13375,5614,5614
2020-10-09,497,495,2,3375,0,40,28,0,9,2,2,434,62766,57040,5726,402542,0,14261,60347,11714,1181,13384,5616,5616
2020-10-10,535,531,4,3210,0,77,49,1,24,7,7,400,63301,57571,5730,405752,0,14338,60747,11763,1182,13408,5623,5623
2020-10-11,60,60,0,597,0,1,7,1,14,4,4,97,63361,57631,5730,406349,0,14339,60844,11770,1183,13422,5627,5627
2020-10-12,911,907,4,3523,0,65,42,1,19,3,3,310,64272,58538,5734,409872,0,14404,61154,11812,1184,13441,5630,5630
2020-10-13,580,573,7,2345,0,89,51,3,13,5,5,247,64852,59111,5741,412217,0,14493,61401,11863,1187,13454,5635,5635
2020-10-14,391,385,6,2350,0,54,30,2,11,4,4,242,65243,59496,5747,414567,0,14547,61643,11893,1189,13465,5639,5639
2020-10-15,343,341,2,2140,0,77,22,0,25,11,11,427,65586,59837,5749,416707,0,14624,62070,11915,1189,13490,5650,5650
2020-10-16,326,321,5,2209,0,97,22,3,20,10,10,505,65912,60158,5754,418916,0,14721,62575,11937,1192,13510,5660,5660
2020-10-17,150,150,0,1484,0,38,11,3,12,7,7,536,66062,60308,5754,420400,0,14759,63111,11948,1195,13522,5667,5667
2020-10-18,59,47,12,409,0,13,7,5,8,4,4,61,66121,60355,5766,420809,0,14772,63172,11955,1200,13530,5671,5671
2020-10-19,234,230,4,1717,0,46,16,7,7,4,4,790,66355,60585,5770,422526,0,14818,63962,11971,1207,13537,5675,5675
2020-10-20,328,317,11,2238,0,88,31,1,31,10,10,523,66683,60902,5781,424764,0,14906,64485,12002,1208,13568,5685,5685
2020-10-21,194,179,15,1402,0,94,33,2,11,4,4,361,66877,61081,5796,426166,0,15000,64846,12035,1210,13579,5689,5689
2020-10-22,271,258,13,1821,0,60,25,2,10,4,4,314,67148,61339,5809,427987,0,15060,65160,12060,1212,13589,5693,5693
2020-10-23,224,223,1,1789,0,42,11,2,4,1,1,324,67372,61562,5810,429776,0,15102,65484,12071,1214,13593,5694,5694
2020-10-24,188,185,3,1394,0,25,17,3,9,2,2,165,67560,61747,5813,431170,0,15127,65649,12088,1217,13602,5696,5696
2020-10-25,31,31,0,342,0,0,3,2,19,0,0,47,67591,61778,5813,431512,0,15127,65696,12091,1219,13621,5696,5696
2020-10-26,257,246,11,1620,0,61,25,1,21,3,3,370,67848,62024,5824,433132,0,15188,66066,12116,1220,13642,5699,5699
2020-10-27,207,206,1,1552,0,60,16,2,7,2,2,393,68055,62230,5825,434684,0,15248,66459,12132,1222,13649,5701,5701
2020-10-28,195,189,6,1457,0,74,19,5,12,2,2,209,68250,62419,5831,436141,0,15322,66668,12151,1227,13661,5703,5703
2020-10-29,191,189,2,1282,0,65,13,3,14,4,4,292,68441,62608,5833,437423,0,15387,66960,12164,1230,13675,5707,5707
2020-10-30,182,182,0,1563,0,73,13,2,22,9,9,245,68623,62790,5833,438986,0,15460,67205,12177,1232,13697,5716,5716
2020-10-31,144,142,2,1459,0,47,17,0,5,3,3,193,68767,62932,5835,440445,0,15507,67398,12194,1232,13702,5719,5719
2020-11-01,51,51,0,388,0,0,11,2,27,5,5,42,68818,62983,5835,440833,0,15507,67440,12205,1234,13729,5724,5724
2020-11-02,166,163,3,1352,0,65,13,1,12,4,4,245,68984,63146,5838,442185,0,15572,67685,12218,1235,13741,5728,5728
2020-11-03,290,278,12,2299,0,39,38,1,9,2,2,222,69274,63424,5850,444484,0,15611,67907,12256,1236,13750,5730,5730
2020-11-04,254,253,1,2000,0,37,29,3,5,1,1,201,69528,63677,5851,446484,0,15648,68108,12285,1239,13755,5731,5731
2020-11-05,221,214,7,1850,0,95,25,1,13,3,3,207,69749,63891,5858,448334,0,15743,68315,12310,1240,13768,5734,5734
2020-11-06,246,244,2,1921,0,46,13,2,14,9,9,179,69995,64135,5860,450255,0,15789,68494,12323,1242,13782,5743,5743
2020-11-07,238,236,2,1466,0,34,18,1,17,8,8,151,70233,64371,5862,451721,0,15823,68645,12341,1243,13799,5751,5751
2020-11-08,285,283,2,1605,0,36,27,2,8,3,3,49,70518,64654,5864,453326,0,15859,68694,12368,1245,13807,5754,5754
2020-11-09,152,151,1,1528,0,48,13,1,12,7,7,176,70670,64805,5865,454854,0,15907,68870,12381,1246,13819,5761,5761
2020-11-10,196,195,1,1902,0,96,15,1,21,8,8,262,70866,65000,5866,456756,0,16003,69132,12396,1247,13840,5769,5769
2020-11-11,167,165,2,1623,0,120,10,2,17,6,6,243,71033,65165,5868,458379,0,16123,69375,12406,1249,13857,5775,5775
2020-11-12,168,160,8,1500,0,156,16,4,13,6,6,211,71201,65325,5876,459879,0,16279,69586,12422,1253,13870,5781,5781
2020-11-13,183,181,2,1639,0,141,13,0,9,6,6,242,71384,65506,5878,461518,0,16420,69828,12435,1253,13879,5787,5787
2020-11-14,133,129,4,1752,0,216,17,1,13,3,3,220,71517,65635,5882,463270,0,16636,70048,12452,1254,13892,5790,5790
2020-11-15,40,40,0,381,0,2,3,1,18,7,7,258,71557,65675,5882,463651,0,16638,70306,12455,1255,13910,5797,5797
2020-11-16,178,170,8,1598,0,233,17,1,18,5,5,158,71735,65845,5890,465249,0,16871,70464,12472,1256,13928,5802,5802
2020-11-17,170,169,1,1767,0,229,6,4,11,6,6,219,71905,66014,5891,467016,0,17100,70683,12478,1260,13939,5808,5808
2020-11-18,155,146,9,1422,0,230,19,1,8,2,2,175,72060,66160,5900,468438,0,17330,70858,12497,1261,13947,5810,5810
2020-11-19,130,118,12,1363,0,166,27,1,11,7,7,169,72190,66278,5912,469801,0,17496,71027,12524,1262,13958,5817,5817
2020-11-20,157,142,15,1380,0,122,26,0,25,18,18,183,72347,66420,5927,471181,0,17618,71210,12550,1262,13983,5835,5835
2020-11-21,123,117,6,1354,0,34,8,1,9,6,6,148,72470,66537,5933,472535,0,17652,71358,12558,1263,13992,5841,5841
2020-11-22,97,97,0,545,0,0,20,0,12,6,6,68,72567,66634,5933,473080,0,17652,71426,12578,1263,14004,5847,5847
2020-11-23,156,149,7,1368,0,59,23,2,17,10,10,158,72723,66783,5940,474448,0,17711,71584,12601,1265,14021,5857,5857
2020-11-24,200,195,5,1811,0,61,16,1,9,7,7,173,72923,66978,5945,476259,0,17772,71757,12617,1266,14030,5864,5864
2020-11-25,191,182,9,1499,0,72,14,2,7,4,4,148,73114,67160,5954,477758,0,17844,71905,12631,1268,14037,5868,5868
2020-11-26,145,132,13,1623,0,61,20,2,7,2,2,131,73259,67292,5967,479381,0,17905,72036,12651,1270,14044,5870,5870
2020-11-27,274,253,21,2057,0,74,30,0,12,7,7,148,73533,67545,5988,481438,0,17979,72184,12681,1270,14056,5877,5877
2020-11-28,274,270,4,2017,0,52,11,0,13,9,9,122,73807,67815,5992,483455,0,18031,72306,12692,1270,14069,5886,5886
2020-11-29,28,28,0,312,0,2,8,2,11,7,7,90,73835,67843,5992,483767,0,18033,72396,12700,1272,14080,5893,5893
2020-11-30,161,151,10,1490,0,62,19,0,14,9,9,164,73996,67994,6002,485257,0,18095,72560,12719,1272,14094,5902,5902
2020-12-01,136,117,19,1400,0,60,27,0,21,8,8,198,74132,68111,6021,486657,0,18155,72758,12746,1272,14115,5910,5910
2020-12-02,134,131,3,1563,0,39,12,4,4,3,3,201,74266,68242,6024,488220,0,18194,72959,12758,1276,14119,5913,5913
2020-12-03,95,85,10,1193,0,41,19,1,10,4,4,136,74361,68327,6034,489413,0,18235,73095,12777,1277,14129,5917,5917
2020-12-04,149,131,18,1373,0,63,30,3,10,3,3,259,74510,68458,6052,490786,0,18298,73354,12807,1280,14139,5920,5920
2020-12-05,118,116,2,1141,0,60,9,2,15,5,5,256,74628,68574,6054,491927,0,18358,73610,12816,1282,14154,5925,5925
2020-12-06,36,36,0,285,0,1,2,0,6,1,1,36,74664,68610,6054,492212,0,18359,73646,12818,1282,14160,5926,5926
2020-12-07,110,106,4,1052,0,70,14,1,12,9,9,157,74774,68716,6058,493264,0,18429,73803,12832,1283,14172,5935,5935
2020-12-08,67,61,6,787,0,75,9,1,8,6,6,120,74841,68777,6064,494051,0,18504,73923,12841,1284,14180,5941,5941
2020-12-09,132,129,3,1500,0,31,11,4,9,5,5,142,74973,68906,6067,495551,0,18535,74065,12852,1288,14189,5946,5946
2020-12-10,108,103,5,1323,0,58,15,2,15,12,12,110,75081,69009,6072,496874,0,18593,74175,12867,1290,14204,5958,5958
2020-12-11,215,210,5,1702,0,71,18,1,14,11,11,149,75296,69219,6077,498576,0,18664,74324,12885,1291,14218,5969,5969
2020-12-12,160,148,12,1237,0,50,21,1,12,8,8,126,75456,69367,6089,499813,0,18714,74450,12906,1292,14230,5977,5977
2020-12-13,32,32,0,292,0,1,4,0,15,9,9,37,75488,69399,6089,500105,0,18715,74487,12910,1292,14245,5986,5986
2020-12-14,107,96,11,1125,0,61,25,3,19,14,14,119,75595,69495,6100,501230,0,18776,74606,12935,1295,14264,6000,6000
2020-12-15,215,211,4,2071,0,88,24,3,27,20,20,95,75810,69706,6104,503301,0,18864,74701,12959,1298,14291,6020,6020
2020-12-16,314,308,6,1930,0,52,18,2,18,12,12,127,76124,70014,6110,505231,0,18916,74828,12977,1300,14309,6032,6032
2020-12-17,198,178,20,1810,0,109,28,2,19,19,19,100,76322,70192,6130,507041,0,19025,74928,13005,1302,14328,6051,6051
2020-12-18,284,272,12,2232,0,82,22,0,17,12,12,236,76606,70464,6142,509273,0,19107,75164,13027,1302,14345,6063,6063
2020-12-19,316,307,9,2391,0,32,18,0,10,6,6,157,76922,70771,6151,511664,0,19139,75321,13045,1302,14355,6069,6069
2020-12-20,44,44,0,330,0,0,2,0,14,9,9,29,76966,70815,6151,511994,0,19139,75350,13047,1302,14369,6078,6078
2020-12-21,127,101,26,1170,0,88,35,2,13,9,9,108,77093,70916,6177,513164,0,19227,75458,13082,1304,14382,6087,6087
2020-12-22,63,56,7,1053,0,62,10,4,20,15,15,175,77156,70972,6184,514217,0,19289,75633,13092,1308,14402,6102,6102
2020-12-23,112,82,30,992,0,86,33,3,27,25,25,286,77268,71054,6214,515209,0,19375,75919,13125,1311,14429,6127,6127
2020-12-24,67,59,8,461,0,40,13,1,30,22,22,183,77335,71113,6222,515670,0,19415,76102,13138,1312,14459,6149,6149
2020-12-25,26,26,0,168,0,0,0,2,21,19,19,263,77361,71139,6222,515838,0,19415,76365,13138,1314,14480,6168,6168
2020-12-26,76,59,17,774,0,61,18,0,27,17,17,306,77437,71198,6239,516612,0,19476,76671,13156,1314,14507,6185,6185
2020-12-27,32,32,0,238,0,0,3,0,15,9,9,42,77469,71230,6239,516850,0,19476,76713,13159,1314,14522,6194,6194
2020-12-28,108,94,14,881,0,58,21,4,38,26,26,112,77577,71324,6253,517731,0,19534,76825,13180,1318,14560,6220,6220
2020-12-29,129,96,33,1081,0,86,35,0,28,19,19,92,77706,71420,6286,518812,0,19620,76917,13215,1318,14588,6239,6239
2020-12-30,73,51,22,787,0,70,26,2,38,26,26,118,77779,71471,6308,519599,0,19690,77035,13241,1320,14626,6265,6265
2020-12-31,71,46,25,756,0,101,29,1,28,22,22,94,77850,71517,6333,520355,0,19791,77129,13270,1321,14654,6287,6287
2021-01-01,45,27,18,296,0,83,26,1,63,44,44,66,77895,71544,6351,520651,0,19874,77195,13296,1322,14717,6331,6331
2021-01-02,62,58,4,635,0,34,6,0,46,28,28,88,77957,71602,6355,521286,0,19908,77283,13302,1322,14763,6359,6359
2021-01-03,33,33,0,318,0,0,3,2,46,34,34,36,77990,71635,6355,521604,0,19908,77319,13305,1324,14809,6393,6393
2021-01-04,137,107,30,1208,0,138,37,1,54,40,40,113,78127,71742,6385,522812,0,20046,77432,13342,1325,14863,6433,6433
2021-01-05,107,87,20,1066,0,90,33,1,41,30,30,98,78234,71829,6405,523878,0,20136,77530,13375,1326,14904,6463,6463
2021-01-06,147,97,50,1218,0,156,62,1,52,41,41,84,78381,71926,6455,525096,0,20292,77614,13437,1327,14956,6504,6504
2021-01-07,147,118,29,1412,0,156,37,5,55,36,36,52,78528,72044,6484,526508,0,20448,77666,13474,1332,15011,6540,6540
2021-01-08,177,134,43,1301,0,137,60,9,75,58,58,20,78705,72178,6527,527809,0,20585,77686,13534,1341,15086,6598,6598
2021-01-09,133,109,24,1278,0,137,37,3,58,47,47,76,78838,72287,6551,529087,0,20722,77762,13571,1344,15144,6645,6645
2021-01-10,58,58,0,402,0,1,7,4,105,83,83,30,78896,72345,6551,529489,0,20723,77792,13578,1348,15249,6728,6728
2021-01-11,167,136,31,1273,0,135,52,4,70,56,56,117,79063,72481,6582,530762,0,20858,77909,13630,1352,15319,6784,6784
2021-01-12,161,112,49,1508,0,302,70,2,72,54,54,126,79224,72593,6631,532270,0,21160,78035,13700,1354,15391,6838,6838
2021-01-13,161,99,62,1126,0,188,79,7,50,35,35,117,79385,72692,6693,533396,0,21348,78152,13779,1361,15441,6873,6873
2021-01-14,197,146,51,1401,0,184,73,5,49,40,40,130,79582,72838,6744,534797,0,21532,78282,13852,1366,15490,6913,6913
2021-01-15,400,356,44,2315,0,221,72,4,72,54,54,138,79982,73194,6788,537112,0,21753,78420,13924,1370,15562,6967,6967
2021-01-16,301,198,103,1891,0,362,124,6,50,40,40,103,80283,73392,6891,539003,0,22115,78523,14048,1376,15612,7007,7007
2021-01-17,68,64,4,393,0,4,26,5,45,38,38,57,80351,73456,6895,539396,0,22119,78580,14074,1381,15657,7045,7045
2021-01-18,266,183,83,1264,0,298,105,8,38,30,30,157,80617,73639,6978,540660,0,22417,78737,14179,1389,15695,7075,7075
2021-01-19,197,147,50,1174,0,191,78,4,26,22,22,129,80814,73786,7028,541834,0,22608,78866,14257,1393,15721,7097,7097
2021-01-20,311,202,109,1482,0,290,142,6,11,8,8,141,81125,73988,7137,543316,0,22898,79007,14399,1399,15732,7105,7105
2021-01-21,254,204,50,1609,0,402,104,10,11,10,10,172,81379,74192,7187,544925,0,23300,79179,14503,1409,15743,7115,7115
2021-01-22,248,173,75,1486,0,221,124,9,0,0,0,382,81627,74365,7262,546411,0,23521,79561,14627,1418,15743,7115,7115
2021-01-23,181,103,78,809,0,210,101,9,,,,215,81808,74468,7340,547220,0,23731,79776,14728,1427,15743,7115,7115
2021-01-24,12,12,0,70,0,0,5,3,,,,67,81820,74480,7340,547290,0,23731,79843,14733,1430,15743,7115,7115
2021-01-25,,,,,,,,,,,,213,81820,74480,7340,547290,0,23731,80056,14733,1430,15743,7115,7115
2021-01-26,,,,,,,,,,,,185,81820,74480,7340,547290,0,23731,80241,14733,1430,15743,7115,7115
2021-01-27,,,,,,,,,,,,249,81820,74480,7340,547290,0,23731,80490,14733,1430,15743,7115,7115
2021-01-28,,,,,,,,,,,,243,81820,74480,7340,547290,0,23731,80733,14733,1430,15743,7115,7115
2021-01-29,,,,,,,,,,,,229,81820,74480,7340,547290,0,23731,80962,14733,1430,15743,7115,7115
2021-01-30,,,,,,,,,,,,221,81820,74480,7340,547290,0,23731,81183,14733,1430,15743,7115,7115
2021-01-31,,,,,,,,,,,,22,81820,74480,7340,547290,0,23731,81205,14733,1430,15743,7115,7115
2021-02-01,,,,,,,,,,,,118,81820,74480,7340,547290,0,23731,81323,14733,1430,15743,7115,7115
2021-02-02,,,,,,,,,,,,97,81820,74480,7340,547290,0,23731,81420,14733,1430,15743,7115,7115
2021-02-03,,,,,,,,,,,,157,81820,74480,7340,547290,0,23731,81577,14733,1430,15743,7115,7115
2021-02-04,,,,,,,,,,,,121,81820,74480,7340,547290,0,23731,81698,14733,1430,15743,7115,7115
2021-02-05,,,,,,,,,,,,117,81820,74480,7340,547290,0,23731,81815,14733,1430,15743,7115,7115
2021-02-06,,,,,,,,,,,,102,81820,74480,7340,547290,0,23731,81917,14733,1430,15743,7115,7115
2021-02-07,,,,,,,,,,,,3,81820,74480,7340,547290,0,23731,81920,14733,1430,15743,7115,7115
,,,,,,,,,0,0,0,0,81820,74480,7340,547290,0,23731,81920,14733,1430,15743,7115,7115
